Abbotsford Crescent  	 Wednesday
Abbotsford Park  	 Wednesday
Abercorn Avenue  	 Friday
Abercorn Cottages  	 Friday
Abercorn Crescent  	 Friday
Abercorn Drive  	 Friday
Abercorn Gardens  	 Tuesday
Abercorn Grove  	 Friday
Abercorn Road  	 Friday
Abercorn Terrace  	 Friday
Abercromby Place  	 Tuesday
Abinger Gardens  	 Friday
Achnacarry Street  	 Thursday
Adams Well  	 Wednesday
Adamslaw Place  	 Friday
Addiston Crescent  	 Wednesday
Addiston Farm Road  	 Thursday
Addiston Grove  	 Wednesday
Addiston Park  	 Wednesday
Adelphi Grove  	 Friday
Adelphi Place  	 Friday
Adit Place  	 Thursday
Admiral Terrace  	 Tuesday
Affleck Court  	 Thursday
Affleck Way  	 Wednesday
Afton Place  	 Tuesday
Afton Terrace  	 Tuesday
Ainslie Place  	 Tuesday
Aitchison'S Place  	 Friday
Alan Breck Gardens  	 Friday
Albany Lane  	 Tuesday
Albany Street  	 Tuesday
Albany Street Lane  	 Tuesday
Albert Terrace  	 Wednesday
Alcorn Square  	 Wednesday
Alderbank Gardens  	 Tuesday
Alderbank Place  	 Tuesday
Alderbank Terrace  	 Tuesday
Aldermoor Avenue  	 Wednesday
Alemoor Crescent  	 Tuesday
Alemoor Park  	 Tuesday
Alexander Drive  	 Friday
Alfred Place  	 Friday
Allan Park  	 Thursday
Allan Park Crescent  	 Wednesday
Allan Park Drive  	 Wednesday
Allan Park Gardens  	 Wednesday
Allan Park Loan  	 Wednesday
Allan Park Road  	 Wednesday
Allermuir Road  	 Wednesday
Allison Place  	 Thursday
Almond Bank Cottages  	 Thursday
Almond Green  	 Thursday
Almond Grove  	 Thursday
Almond Square  	 Thursday
Almondbank Terrace  	 Tuesday
Almondhill  	 Thursday
Almondhill Road  	 Thursday
Almondhill Steading  	 Thursday
Almondside  	 Thursday
Alnwickhill Court  	 Thursday
Alnwickhill Crescent  	 Thursday
Alnwickhill Drive  	 Thursday
Alnwickhill Gardens  	 Thursday
Alnwickhill Grove  	 Thursday
Alnwickhill Loan  	 Thursday
Alnwickhill Park  	 Thursday
Alnwickhill Road  	 Thursday
Alnwickhill Terrace  	 Thursday
Alnwickhill View  	 Thursday
Alva Street  	 Tuesday
Amos Crescent  	 Thursday
Amos Crossway  	 Thursday
Amos Place  	 Thursday
Andrew Balfour Grove  	 Friday
Angle Park Terrace  	 Tuesday
Ann Street  	 Friday
Annandale Street  	 Tuesday
Annandale Street Lane  	 Tuesday
Annfield Street  	 Tuesday
Arboretum Place  	 Tuesday
Arboretum Road  	 Tuesday
Ardmillan Place  	 Tuesday
Ardmillan Terrace  	 Tuesday
Ardshiel Avenue  	 Friday
Argyle Crescent  	 Friday
Argyle Park Terrace  	 Wednesday
Argyle Place  	 Wednesday
Argyle Street  	 Tuesday
Argyll Terrace  	 Tuesday
Arkaig Gardens  	 Thursday
Arnott Gardens  	 Wednesday
Arrol Place  	 Thursday
Arthur Street  	 Tuesday
Ashburnham Gardens  	 Thursday
Ashburnham Loan  	 Thursday
Ashburnham Road  	 Thursday
Ashcroft Lane  	 Wednesday
Ashlar Road  	 Tuesday
Ashley Drive  	 Tuesday
Ashley Gardens  	 Tuesday
Ashley Grange  	 Wednesday
Ashley Grove  	 Tuesday
Ashley Terrace  	 Tuesday
Ashton Grove  	 Friday
Ashton Villas  	 Friday
Ashville Terrace  	 Tuesday
Ashwood Gait  	 Friday
Aspen Road  	 Friday
Atheling Grove  	 Thursday
Atholl Crescent  	 Tuesday
Atholl Crescent Lane  	 Tuesday
Atholl Terrace  	 Tuesday
Auchingane  	 Thursday
Auchinleck'S Brae  	 Tuesday
Auldgate  	 Thursday
Avenel  	 Thursday
Avenue Villas  	 Tuesday
Avon Grove  	 Thursday
Avon Place  	 Thursday
Avon Road  	 Thursday
Avondale Place  	 Tuesday
Baberton Avenue  	 Wednesday
Baberton Crescent  	 Wednesday
Baberton Loan  	 Wednesday
Baberton Mains  	 Wednesday
Baberton Mains Avenue  	 Wednesday
Baberton Mains Bank  	 Wednesday
Baberton Mains Brae  	 Wednesday
Baberton Mains Court  	 Wednesday
Baberton Mains Crescent  	 Wednesday
Baberton Mains Dell  	 Wednesday
Baberton Mains Drive  	 Wednesday
Baberton Mains Gardens  	 Wednesday
Baberton Mains Green  	 Wednesday
Baberton Mains Grove  	 Wednesday
Baberton Mains Hill  	 Wednesday
Baberton Mains Lea  	 Wednesday
Baberton Mains Loan  	 Wednesday
Baberton Mains Park  	 Wednesday
Baberton Mains Place  	 Wednesday
Baberton Mains Rise  	 Wednesday
Baberton Mains Row  	 Wednesday
Baberton Mains Terrace  	 Wednesday
Baberton Mains View  	 Wednesday
Baberton Mains Way  	 Wednesday
Baberton Mains Wood  	 Wednesday
Baberton Mains Wynd  	 Wednesday
Baberton Park  	 Wednesday
Baberton Road  	 Wednesday
Baberton Square  	 Wednesday
Back Dean  	 Friday
Back Station Road  	 Friday
Backlee  	 Thursday
Badger Neuk  	 Thursday
Badger Way  	 Thursday
Baileyfield Crescent  	 Friday
Baileyfield Road  	 Friday
Bailie Grove  	 Friday
Bailie Path  	 Friday
Bailie Place  	 Friday
Bailie Terrace  	 Friday
Baird Avenue  	 Friday
Baird Drive  	 Friday
Baird Gardens  	 Friday
Baird Grove  	 Friday
Baird Road  	 Thursday
Baird Terrace  	 Friday
Baker Mews  	 Thursday
Baker Wynd  	 Thursday
Balbirnie Place  	 Friday
Balcarres Street  	 Wednesday
Balcomie Gardens  	 Thursday
Balderston Gardens  	 Friday
Balderston Gardens North  	 Friday
Balfour Street  	 Tuesday
Balfron Loan  	 Friday
Balgreen Avenue  	 Friday
Balgreen Gardens  	 Friday
Balgreen Park  	 Friday
Balgreen Road  	 Friday
Ballantyne Place  	 Wednesday
Balmoral Place  	 Tuesday
Balmwell Avenue  	 Thursday
Balmwell Grove  	 Thursday
Balmwell Park  	 Thursday
Balmwell Terrace  	 Thursday
Balneil Place  	 Thursday
Bangholm Avenue  	 Tuesday
Bangholm Bower Avenue  	 Tuesday
Bangholm Grove  	 Tuesday
Bangholm Loan  	 Tuesday
Bangholm Park  	 Tuesday
Bangholm Road  	 Tuesday
Bangholm Terrace  	 Tuesday
Bangholm View  	 Tuesday
Bangholm Villas  	 Tuesday
Bangor Road  	 Tuesday
Bankhead Drive  	 Wednesday
Bankhead Grove  	 Thursday
Bankhead Road  	 Thursday
Barn Park Crescent  	 Wednesday
Barnshot Road  	 Wednesday
Barntalloch Court  	 Thursday
Barnton Avenue  	 Tuesday
Barnton Avenue West  	 Thursday
Barnton Brae  	 Thursday
Barnton Gardens  	 Tuesday
Barnton Grove  	 Thursday
Barnton Loan  	 Tuesday
Barnton Park  	 Tuesday
Barnton Park Avenue  	 Thursday
Barnton Park Crescent  	 Thursday
Barnton Park Dell  	 Thursday
Barnton Park Drive  	 Thursday
Barnton Park Gardens  	 Thursday
Barnton Park Grove  	 Thursday
Barnton Park Place  	 Thursday
Barnton Park View  	 Thursday
Barnton Park Wood  	 Thursday
Barntongate Avenue  	 Thursday
Barntongate Drive  	 Thursday
Barntongate Terrace  	 Thursday
Barnyard Park Crescent  	 Wednesday
Barnyard Park Loan  	 Wednesday
Barnyard Park Rigg  	 Wednesday
Baronscourt Road  	 Friday
Baronscourt Terrace  	 Friday
Baronscraig Cottage Westfield  	 Thursday
Barony Street  	 Tuesday
Barony Terrace  	 Friday
Bath Place  	 Friday
Bath Street  	 Friday
Bathfield  	 Tuesday
Bauld Drive  	 Friday
Bavelaw Gardens  	 Wednesday
Bavelaw Green  	 Wednesday
Bavelaw Road  	 Wednesday
Beach Lane  	 Friday
Beale Drive  	 Thursday
Beale Green  	 Thursday
Beauchamp Grove  	 Thursday
Beauchamp Road  	 Thursday
Beaufort Road  	 Wednesday
Bedford Terrace  	 Friday
Beechmount Crescent  	 Friday
Beechmount Park  	 Friday
Beechwood Mains  	 Friday
Beechwood Terrace  	 Tuesday
Belford Avenue  	 Friday
Belford Gardens  	 Friday
Belford Mews  	 Friday
Belford Park  	 Friday
Belford Place  	 Friday
Belford Road  	 Friday
Belford Terrace  	 Friday
Belgrave Crescent  	 Friday
Belgrave Crescent Lane  	 Friday
Belgrave Gardens  	 Friday
Belgrave Place  	 Friday
Belgrave Road  	 Friday
Belgrave Terrace  	 Friday
Bell Place  	 Tuesday
Bell'S Mills  	 Friday
Bell'S Mills  	 Thursday
Bellenden Gardens  	 Friday
Bellevue Crescent  	 Tuesday
Bellevue Gardens  	 Tuesday
Bellevue Grove  	 Tuesday
Bellevue Place  	 Tuesday
Bellevue Road  	 Tuesday
Bellevue Street  	 Tuesday
Bellevue Terrace  	 Tuesday
Bellfield Lane  	 Friday
Bellfield Street  	 Friday
Bellfield Terrace  	 Friday
Bellrock Park  	 Thursday
Belmont Avenue  	 Friday
Belmont Crescent  	 Friday
Belmont Drive  	 Friday
Belmont Gardens  	 Friday
Belmont Park  	 Friday
Belmont Road  	 Wednesday
Belmont Terrace  	 Friday
Belmont View  	 Friday
Belvedere Park  	 Tuesday
Benhar Road  	 Friday
Beresford Avenue  	 Tuesday
Beresford Gardens  	 Tuesday
Beresford Place  	 Tuesday
Beresford Terrace  	 Tuesday
Bernard Street  	 Tuesday
Berry Drive  	 Thursday
Berry Way  	 Thursday
Biggar Road  	 Thursday
Bill Douglas Grove  	 Friday
Bingham Avenue  	 Friday
Bingham Broadway  	 Friday
Bingham Crescent  	 Friday
Bingham Crossway  	 Friday
Bingham Drive  	 Friday
Bingham Medway  	 Friday
Bingham Place  	 Friday
Bingham Way  	 Friday
Birch Court  	 Thursday
Birchwood View  	 Friday
Blackadder Drive  	 Wednesday
Blackbarony Road  	 Wednesday
Blackburn Crag  	 Thursday
Blackchapel Close  	 Friday
Blackchapel Road  	 Friday
Blacket Avenue  	 Friday
Blacket Place  	 Friday
Blackford Avenue  	 Wednesday
Blackford Bank  	 Wednesday
Blackford Glen Road  	 Thursday
Blackford Hill Grove  	 Wednesday
Blackford Hill Rise  	 Wednesday
Blackford Hill View  	 Wednesday
Blackford Road  	 Wednesday
Blackie Road  	 Tuesday
Blackthorn Court  	 Thursday
Blaeberry Gardens  	 Thursday
Blantyre Terrace  	 Wednesday
Bleachfield  	 Tuesday
Blenheim Place  	 Tuesday
Blinkbonny Avenue  	 Friday
Blinkbonny Crescent  	 Friday
Blinkbonny Gardens  	 Friday
Blinkbonny Grove  	 Friday
Blinkbonny Grove West  	 Friday
Blinkbonny Terrace  	 Friday
Bluebell Terrace  	 Friday
Boat Green  	 Tuesday
Bogsmill Road  	 Wednesday
Bonaly Avenue  	 Wednesday
Bonaly Brae  	 Wednesday
Bonaly Crescent  	 Wednesday
Bonaly Drive  	 Wednesday
Bonaly Gardens  	 Wednesday
Bonaly Grove  	 Wednesday
Bonaly Rise  	 Wednesday
Bonaly Road  	 Wednesday
Bonaly Steading  	 Wednesday
Bonaly Terrace  	 Wednesday
Bonaly Wester  	 Wednesday
Bonnington  	 Thursday
Bonnington Avenue  	 Tuesday
Bonnington Grove  	 Tuesday
Bonnington Road  	 Tuesday
Bonnington Road  	 Thursday
Bonnington Terrace  	 Tuesday
Bonnybridge Drive  	 Friday
Bonnyhaugh Lane  	 Tuesday
Boothacre Cottages  	 Tuesday
Boothacre Lane  	 Tuesday
Borrowman Square  	 Thursday
Borthwick Place  	 Friday
Boswall Avenue  	 Tuesday
Boswall Crescent  	 Tuesday
Boswall Drive  	 Tuesday
Boswall Gardens  	 Tuesday
Boswall Green  	 Tuesday
Boswall Grove  	 Tuesday
Boswall Loan  	 Tuesday
Boswall Parkway  	 Tuesday
Boswall Place  	 Tuesday
Boswall Quadrant  	 Tuesday
Boswall Road  	 Tuesday
Boswall Square  	 Tuesday
Boswall Terrace  	 Tuesday
Bowbridge Crescent  	 Thursday
Bowes Place  	 Friday
Bowling Green Road  	 Thursday
Bowling Lane  	 Tuesday
Bowmont Place  	 Wednesday
Brackenridge View  	 Thursday
Bradshaw Drive  	 Thursday
Bradshaw Lane  	 Thursday
Brae Park  	 Thursday
Brae Park Road  	 Thursday
Braeburn Drive  	 Wednesday
Braefoot Terrace  	 Wednesday
Braehead Avenue  	 Thursday
Braehead Bank  	 Thursday
Braehead Crescent  	 Thursday
Braehead Drive  	 Thursday
Braehead Grove  	 Thursday
Braehead Loan  	 Thursday
Braehead Park  	 Thursday
Braehead Road  	 Thursday
Braehead Row  	 Thursday
Braehead View  	 Thursday
Braid Avenue  	 Wednesday
Braid Crescent  	 Wednesday
Braid Farm Road  	 Wednesday
Braid Hills Approach  	 Thursday
Braid Hills Avenue  	 Wednesday
Braid Hills Crescent  	 Wednesday
Braid Hills Drive  	 Wednesday
Braid Hills Road  	 Wednesday
Braid Mount  	 Thursday
Braid Mount Crest  	 Thursday
Braid Mount Rise  	 Thursday
Braid Mount View  	 Thursday
Braidburn Crescent  	 Wednesday
Braidburn Terrace  	 Wednesday
Bramble Drive  	 Thursday
Bramdean Grove  	 Thursday
Bramdean Place  	 Thursday
Bramdean Rise  	 Thursday
Bramdean View  	 Thursday
Brand Drive  	 Friday
Brand Gardens  	 Friday
Branders Place  	 Thursday
Breadalbane Terrace  	 Tuesday
Brewery Close  	 Thursday
Briarbank Terrace  	 Tuesday
Brickfield  	 Friday
Bridge End  	 Friday
Bridge Place  	 Tuesday
Bridge Street Lane  	 Friday
Briery Bauks  	 Wednesday
Briggers Brae  	 Thursday
Briggers Walk  	 Thursday
Briggers Way  	 Thursday
Briggers Wynd  	 Thursday
Brighouse Park Court  	 Thursday
Brighouse Park Crescent  	 Thursday
Brighouse Park Cross  	 Thursday
Brighouse Park Drive  	 Thursday
Brighouse Park Gait  	 Thursday
Brighouse Park Gardens  	 Thursday
Brighouse Park Rigg  	 Thursday
Bright Terrace  	 Tuesday
Bright'S Crescent  	 Wednesday
Brighton Place  	 Friday
Britwell Crescent  	 Tuesday
Brock View  	 Wednesday
Brocken Brigg End  	 Wednesday
Brocken Brigg Road  	 Thursday
Brogan Crescent  	 Friday
Broombank Terrace  	 Wednesday
Broomburn Grove  	 Wednesday
Broomfield Crescent  	 Wednesday
Broomhall Avenue  	 Wednesday
Broomhall Bank  	 Wednesday
Broomhall Crescent  	 Wednesday
Broomhall Drive  	 Wednesday
Broomhall Gardens  	 Wednesday
Broomhall Loan  	 Wednesday
Broomhall Park  	 Wednesday
Broomhall Place  	 Wednesday
Broomhall Road  	 Wednesday
Broomhall Terrace  	 Wednesday
Broomhouse Avenue  	 Friday
Broomhouse Bank  	 Friday
Broomhouse Cottages  	 Friday
Broomhouse Cottages East  	 Friday
Broomhouse Cottages West  	 Friday
Broomhouse Court  	 Friday
Broomhouse Crescent  	 Friday
Broomhouse Drive  	 Friday
Broomhouse Gardens  	 Friday
Broomhouse Gardens East  	 Friday
Broomhouse Gardens West  	 Friday
Broomhouse Grove  	 Friday
Broomhouse Loan  	 Friday
Broomhouse Market  	 Friday
Broomhouse Medway  	 Friday
Broomhouse Park  	 Friday
Broomhouse Path  	 Friday
Broomhouse Place North  	 Friday
Broomhouse Place South  	 Friday
Broomhouse Row  	 Friday
Broomhouse Square  	 Friday
Broomhouse Street North  	 Friday
Broomhouse Street South  	 Friday
Broomhouse Terrace  	 Friday
Broomhouse Walk  	 Friday
Broomhouse Way  	 Friday
Broomhouse Wynd  	 Friday
Broomlea Crescent  	 Wednesday
Broompark Road  	 Wednesday
Broomside Terrace  	 Wednesday
Broomview Path  	 Wednesday
Broomyknowe  	 Wednesday
Brosie Road  	 Thursday
Brosie Wynd  	 Wednesday
Broughton Place  	 Tuesday
Broughton Place Lane  	 Tuesday
Broughton Road  	 Tuesday
Broughton Street  	 Tuesday
Brunstane Bank  	 Friday
Brunstane Crescent  	 Friday
Brunstane Drive  	 Friday
Brunstane Gardens  	 Friday
Brunstane Gardens Mews  	 Friday
Brunstane Mill Road  	 Friday
Brunstane Road  	 Friday
Brunstane Road North  	 Friday
Brunstane Road South  	 Friday
Brunswick Terrace  	 Tuesday
Bruntsfield Avenue  	 Wednesday
Bruntsfield Crescent  	 Wednesday
Bruntsfield Place  	 Tuesday
Bruntsfield Terrace  	 Wednesday
Bryce Avenue  	 Tuesday
Bryce Crescent  	 Wednesday
Bryce Place  	 Wednesday
Bryce Road  	 Wednesday
Buckingham Terrace  	 Friday
Buckstane Park  	 Thursday
Buckstone Avenue  	 Thursday
Buckstone Bank  	 Thursday
Buckstone Circle  	 Thursday
Buckstone Close  	 Thursday
Buckstone Court  	 Thursday
Buckstone Crescent  	 Thursday
Buckstone Crook  	 Thursday
Buckstone Dell  	 Thursday
Buckstone Drive  	 Thursday
Buckstone Gardens  	 Thursday
Buckstone Gate  	 Thursday
Buckstone Green  	 Thursday
Buckstone Grove  	 Thursday
Buckstone Hill  	 Thursday
Buckstone Howe  	 Thursday
Buckstone Lea  	 Thursday
Buckstone Loan  	 Thursday
Buckstone Loan East  	 Thursday
Buckstone Neuk  	 Thursday
Buckstone Place  	 Thursday
Buckstone Rise  	 Thursday
Buckstone Road  	 Thursday
Buckstone Row  	 Thursday
Buckstone Shaw  	 Thursday
Buckstone Terrace  	 Thursday
Buckstone View  	 Thursday
Buckstone Way  	 Thursday
Buckstone Wood  	 Thursday
Buckstone Wynd  	 Thursday
Bughtlin Drive  	 Thursday
Bughtlin Gardens  	 Thursday
Bughtlin Green  	 Thursday
Bughtlin Loan  	 Thursday
Bughtlin Market  	 Thursday
Bughtlin Park  	 Thursday
Bughtlin Place  	 Thursday
Buie Brae  	 Thursday
Buie Haugh  	 Thursday
Buie Rigg  	 Thursday
Builyeon Road  	 Thursday
Bullfinch Row  	 Thursday
Bullfinch Way  	 Thursday
Burdiehouse Avenue  	 Thursday
Burdiehouse Crescent  	 Thursday
Burdiehouse Crossway  	 Thursday
Burdiehouse Drive  	 Thursday
Burdiehouse Loan  	 Thursday
Burdiehouse Medway  	 Thursday
Burdiehouse Place  	 Thursday
Burdiehouse Road  	 Thursday
Burdiehouse Square  	 Thursday
Burdiehouse Street  	 Thursday
Burdiehouse Terrace  	 Thursday
Burdock Road  	 Thursday
Burgess Road  	 Thursday
Burgess Terrace  	 Wednesday
Burghtoft  	 Thursday
Burnbrae  	 Thursday
Burnbrae Avenue  	 Thursday
Burnbrae Drive  	 Thursday
Burnbrae Grove  	 Thursday
Burnbrae Place  	 Thursday
Burndale Place  	 Thursday
Burne Cruick  	 Wednesday
Burnhead Crescent  	 Thursday
Burnhead Grove  	 Thursday
Burnhead Loan  	 Thursday
Burnhead Path East  	 Thursday
Burnhead Path West  	 Thursday
Burns Street  	 Tuesday
Burnside  	 Thursday
Burnside Park  	 Wednesday
Burton Place  	 Thursday
Buteland Road  	 Wednesday
Butlaw  	 Thursday
Byrehope Way  	 Wednesday
Byrne Crescent  	 Wednesday
Cables Wynd  	 Tuesday
Caddell'S Row  	 Thursday
Cadogan Road  	 Thursday
Caerketton Cottages  	 Wednesday
Caerlaverock Court  	 Thursday
Cairnmuir Road  	 Friday
Cairns Drive  	 Wednesday
Cairns Gardens  	 Wednesday
Cairntows Close  	 Friday
Caithness Place  	 Tuesday
Caiyside  	 Thursday
Caiystane Avenue  	 Thursday
Caiystane Crescent  	 Thursday
Caiystane Drive  	 Thursday
Caiystane Gardens  	 Thursday
Caiystane Hill  	 Thursday
Caiystane Terrace  	 Thursday
Caiystane View  	 Thursday
Cakemuir Gardens  	 Friday
Cakemuir Grove  	 Friday
Calder Court  	 Wednesday
Calder Crescent  	 Wednesday
Calder Drive  	 Wednesday
Calder Gardens  	 Wednesday
Calder Grove  	 Wednesday
Calder Park  	 Wednesday
Calder Place  	 Wednesday
Calder Road Gardens  	 Friday
Calder View  	 Wednesday
Calton Road  	 Wednesday
Cambridge Avenue  	 Tuesday
Cambridge Gardens  	 Tuesday
Cambridge Street  	 Tuesday
Cameron Crescent  	 Friday
Cameron House Avenue  	 Friday
Cameron March  	 Friday
Cameron Park  	 Friday
Cameron Terrace  	 Friday
Cameron Toll Gardens  	 Friday
Cammo Bank  	 Thursday
Cammo Brae  	 Thursday
Cammo Crescent  	 Thursday
Cammo Gardens  	 Thursday
Cammo Grove  	 Thursday
Cammo Hill  	 Thursday
Cammo Parkway  	 Thursday
Cammo Place  	 Thursday
Cammo Road  	 Thursday
Cammo Tower Grove  	 Thursday
Cammo Tower Mews  	 Thursday
Cammo Tower View  	 Thursday
Cammo Walk  	 Thursday
Campbell Avenue  	 Friday
Campbell Park Crescent  	 Wednesday
Campbell Park Drive  	 Wednesday
Campbell Road  	 Friday
Campion Road  	 Friday
Camus Avenue  	 Thursday
Camus Park  	 Thursday
Camus Road East  	 Thursday
Camus Road West  	 Thursday
Canaan Lane  	 Wednesday
Canalside  	 Thursday
Candlemaker Row  	 Wednesday
Candlemaker'S Crescent  	 Thursday
Candlemaker'S Park  	 Thursday
Canmore Street  	 Thursday
Canon Street  	 Tuesday
Capelaw Road  	 Wednesday
Capella Gardens  	 Friday
Captain'S Drive  	 Thursday
Captain'S Loan  	 Thursday
Captain'S Road  	 Thursday
Captain'S Row  	 Thursday
Carberry Place  	 Friday
Carfrae Gardens  	 Friday
Carfrae Grove  	 Friday
Carfrae Park  	 Friday
Carfrae Road  	 Friday
Cargil Court  	 Tuesday
Cargil Terrace  	 Tuesday
Cargilfield View  	 Thursday
Carlow Gardens  	 Thursday
Carlowrie Avenue  	 Thursday
Carlowrie Crescent  	 Thursday
Carlton Terrace  	 Tuesday
Carlton Terrace Mews  	 Tuesday
Carmel Avenue  	 Thursday
Carmel Road  	 Thursday
Carmelite Road  	 Thursday
Carnbee Avenue  	 Thursday
Carnbee Crescent  	 Thursday
Carnbee Dell  	 Thursday
Carnbee End  	 Thursday
Carnbee Park  	 Thursday
Carnethy Avenue  	 Wednesday
Caroline Gardens  	 Friday
Caroline Park  	 Tuesday
Caroline Place  	 Friday
Caroline Terrace  	 Friday
Carrick Knowe Avenue  	 Wednesday
Carrick Knowe Drive  	 Wednesday
Carrick Knowe Gardens  	 Wednesday
Carrick Knowe Grove  	 Wednesday
Carrick Knowe Hill  	 Wednesday
Carrick Knowe Loan  	 Wednesday
Carrick Knowe Parkway  	 Wednesday
Carrick Knowe Place  	 Wednesday
Carrick Knowe Road  	 Wednesday
Carrick Knowe Terrace  	 Wednesday
Carrie Grove  	 Thursday
Carrington Road  	 Tuesday
Carswell Crescent  	 Thursday
Carswell Loan  	 Thursday
Carswell Walk  	 Thursday
Carter Drive  	 Thursday
Carter Mews  	 Thursday
Casselbank Street  	 Tuesday
Casselbank Street  	 Thursday
Cassidy Wynd  	 Wednesday
Castle Avenue  	 Wednesday
Castle Boathouse Bridge Road  	 Thursday
Castle Gogar Rigg  	 Thursday
Castle Street  	 Tuesday
Castlebrae Avenue  	 Friday
Castlebrae Glebe  	 Friday
Castlebrae Grove  	 Friday
Castlebrae Place  	 Friday
Castlebrae Rigg  	 Friday
Castlebrae Wynd  	 Friday
Castlehill  	 Wednesday
Castlelaw Road  	 Wednesday
Castlepark Gait  	 Friday
Castlepark Glade  	 Friday
Castlepark Green  	 Friday
Castleview Avenue  	 Friday
Castleview Drive  	 Friday
Castleview Grove  	 Friday
Castleview Terrace  	 Friday
Catchilraw Drive  	 Thursday
Catelbock Close  	 Thursday
Catelbock Gardens  	 Thursday
Catstane Road  	 Thursday
Caulderhame Road  	 Wednesday
Causewayside  	 Wednesday
Cavalry Park Drive  	 Friday
Chalmers Buildings  	 Tuesday
Chalmers Crescent  	 Wednesday
Chamberlain Road  	 Wednesday
Chancelot Crescent  	 Tuesday
Chancelot Grove  	 Tuesday
Chapel Lane  	 Tuesday
Chapel Lane  	 Thursday
Charterhall Grove  	 Wednesday
Charterhall Road  	 Wednesday
Cherry Tree Avenue  	 Wednesday
Cherry Tree Crescent  	 Wednesday
Cherry Tree Gardens  	 Wednesday
Cherry Tree Grove  	 Wednesday
Cherry Tree Loan  	 Wednesday
Cherry Tree Park  	 Wednesday
Cherry Tree Place  	 Wednesday
Cherry Tree View  	 Wednesday
Chesser Avenue  	 Friday
Chesser Cottages  	 Friday
Chesser Crescent  	 Friday
Chesser Gardens  	 Friday
Chesser Grove  	 Friday
Chesser Loan  	 Friday
Chester Street  	 Friday
Christian Crescent  	 Friday
Christian Grove  	 Friday
Christie Miller Avenue  	 Tuesday
Christie Miller Grove  	 Tuesday
Christie Miller Place  	 Tuesday
Christie Road  	 Wednesday
Church Hill  	 Wednesday
Churchhill Drive  	 Wednesday
Circus Gardens  	 Tuesday
Circus Lane  	 Tuesday
Citadel Place  	 Tuesday
Clackmae Grove  	 Thursday
Clackmae Road  	 Thursday
Clapper Lane  	 Thursday
Clarebank Crescent  	 Tuesday
Claremont Bank  	 Tuesday
Claremont Crescent  	 Tuesday
Claremont Gardens  	 Tuesday
Claremont Grove  	 Tuesday
Claremont Park  	 Tuesday
Claremont Road  	 Tuesday
Clarence Street  	 Tuesday
Clarendon Crescent  	 Friday
Clarinda Terrace  	 Thursday
Clark Avenue  	 Tuesday
Clark Road  	 Tuesday
Clarkson Road  	 Wednesday
Claverhouse Drive  	 Thursday
Clayhills Grove  	 Wednesday
Clayhills Park  	 Wednesday
Claylands Road  	 Thursday
Clearburn Crescent  	 Friday
Clearburn Gardens  	 Friday
Clearburn Road  	 Friday
Cleekim Drive  	 Friday
Cleekim Road  	 Friday
Cleghorn Road  	 Tuesday
Cleikiminfield  	 Friday
Cleikiminrig  	 Friday
Cleric'S Hill  	 Thursday
Clermiston Avenue  	 Thursday
Clermiston Crescent  	 Thursday
Clermiston Drive  	 Thursday
Clermiston Gardens  	 Thursday
Clermiston Green  	 Thursday
Clermiston Grove  	 Thursday
Clermiston Hill  	 Thursday
Clermiston Loan  	 Thursday
Clermiston Medway  	 Thursday
Clermiston Park  	 Thursday
Clermiston Place  	 Thursday
Clermiston Road  	 Friday
Clermiston Road North  	 Thursday
Clermiston Terrace  	 Friday
Clermiston View  	 Thursday
Clerwood Bank  	 Friday
Clerwood Gardens  	 Friday
Clerwood Grove  	 Friday
Clerwood Loan  	 Friday
Clerwood Park  	 Friday
Clerwood Place  	 Friday
Clerwood Row  	 Friday
Clerwood Terrace  	 Friday
Clerwood View  	 Friday
Clerwood Way  	 Friday
Clifton Road  	 Thursday
Cliftonhall Road  	 Thursday
Clinton Road  	 Wednesday
Clippens Drive  	 Thursday
Clovenstone Drive  	 Wednesday
Clovenstone Gardens  	 Wednesday
Clovenstone Park  	 Wednesday
Clover Gait  	 Tuesday
Clover Park  	 Tuesday
Clufflat  	 Thursday
Clufflat Brae  	 Thursday
Cluny Avenue  	 Wednesday
Cluny Drive  	 Wednesday
Cluny Gardens  	 Wednesday
Cluny Place  	 Wednesday
Cluny Terrace  	 Wednesday
Coates Crescent  	 Tuesday
Coates Gardens  	 Friday
Coates Place  	 Tuesday
Cobbler'S Close  	 Thursday
Cobden Crescent  	 Wednesday
Cobden Road  	 Wednesday
Cobden Terrace  	 Tuesday
Cobden Terrace  	 Thursday
Coburg Street  	 Tuesday
Cochran Terrace  	 Tuesday
Cochrane Place  	 Tuesday
Cockburn Crescent  	 Wednesday
Cockburnhill Road  	 Wednesday
Coillesdene Avenue  	 Friday
Coillesdene Crescent  	 Friday
Coillesdene Drive  	 Friday
Coillesdene Gardens  	 Friday
Coillesdene Grove  	 Friday
Coillesdene Loan  	 Friday
Coillesdene Terrace  	 Friday
Colinton Grove  	 Wednesday
Colinton Grove West  	 Wednesday
Colinton Mains Crescent  	 Wednesday
Colinton Mains Drive  	 Wednesday
Colinton Mains Gardens  	 Wednesday
Colinton Mains Green  	 Wednesday
Colinton Mains Grove  	 Wednesday
Colinton Mains Loan  	 Wednesday
Colinton Mains Place  	 Wednesday
Colinton Mains Road  	 Wednesday
Colinton Mains Terrace  	 Wednesday
Colinton Road  	 Wednesday
Collier Place  	 Friday
Collins Place  	 Tuesday
Colmestone Gate  	 Thursday
Coltbridge Avenue  	 Friday
Coltbridge Gardens  	 Friday
Coltbridge Millside  	 Friday
Coltbridge Terrace  	 Friday
Coltbridge Vale  	 Friday
Columba Avenue  	 Tuesday
Columba Road  	 Friday
Colville Place  	 Tuesday
Combe Cruik  	 Wednesday
Combe Road  	 Wednesday
Comely Bank  	 Friday
Comely Bank Grove  	 Friday
Comely Bank Place Mews  	 Friday
Comely Bank Road  	 Friday
Comely Bank Street  	 Friday
Comfrey Way  	 Thursday
Comiston Drive  	 Wednesday
Comiston Gardens  	 Wednesday
Comiston Grove  	 Thursday
Comiston Place  	 Wednesday
Comiston Rise  	 Thursday
Comiston Road  	 Wednesday
Comiston Springs Avenue  	 Thursday
Comiston View  	 Thursday
Commercial Street  	 Tuesday
Connaught Place  	 Tuesday
Considine Gardens  	 Friday
Considine Terrace  	 Friday
Constitution Place  	 Tuesday
Constitution Street  	 Tuesday
Corbiehill Avenue  	 Tuesday
Corbiehill Crescent  	 Tuesday
Corbiehill Gardens  	 Tuesday
Corbiehill Grove  	 Tuesday
Corbiehill Park  	 Tuesday
Corbiehill Place  	 Tuesday
Corbiehill Road  	 Tuesday
Corbiehill Terrace  	 Tuesday
Corbieshot  	 Friday
Corbiewynd  	 Friday
Cornfield Crescent  	 Tuesday
Cornhill Terrace  	 Tuesday
Cornwallis Place  	 Tuesday
Corrennie Drive  	 Wednesday
Corrennie Gardens  	 Wednesday
Corrigan Street  	 Friday
Corslet Crescent  	 Wednesday
Corslet Place  	 Wednesday
Corslet Road  	 Wednesday
Corstorphine Bank Avenue  	 Friday
Corstorphine Bank Drive  	 Friday
Corstorphine Bank Terrace  	 Friday
Corstorphine High Street  	 Wednesday
Corstorphine Hill Avenue  	 Friday
Corstorphine Hill Crescent  	 Friday
Corstorphine Hill Gardens  	 Friday
Corstorphine Hill Road  	 Friday
Corstorphine House Avenue  	 Friday
Corstorphine House Terrace  	 Friday
Corstorphine Park Gardens  	 Friday
Corstorphine Road  	 Friday
Cotlaws  	 Thursday
Cottage Green  	 Thursday
Cottage Park  	 Friday
Coulter Crescent  	 Thursday
Cove Crescent  	 Thursday
Cowan Road  	 Tuesday
Cowgill Gardens  	 Thursday
Craigcrook Avenue  	 Friday
Craigcrook Gardens  	 Friday
Craigcrook Grove  	 Friday
Craigcrook Park  	 Friday
Craigcrook Place  	 Friday
Craigcrook Square  	 Friday
Craigcrook Terrace  	 Friday
Craigend Park  	 Thursday
Craigentarrie Mews  	 Wednesday
Craigentinny Avenue  	 Tuesday
Craigentinny Avenue North  	 Tuesday
Craigentinny Crescent  	 Tuesday
Craigentinny Grove  	 Tuesday
Craigentinny Place  	 Tuesday
Craigentinny Road  	 Tuesday
Craighall Avenue  	 Tuesday
Craighall Bank  	 Tuesday
Craighall Crescent  	 Tuesday
Craighall Gardens  	 Tuesday
Craighall Road  	 Tuesday
Craighall Terrace  	 Tuesday
Craighill Gardens  	 Wednesday
Craighouse Avenue  	 Wednesday
Craighouse Gardens  	 Wednesday
Craighouse Park  	 Wednesday
Craighouse Road  	 Wednesday
Craighouse Terrace  	 Wednesday
Craigievar Square  	 Thursday
Craigievar Wynd  	 Thursday
Craiglea Drive  	 Wednesday
Craiglea Place  	 Wednesday
Craigleith Avenue North  	 Friday
Craigleith Avenue South  	 Friday
Craigleith Bank  	 Friday
Craigleith Crescent  	 Friday
Craigleith Drive  	 Friday
Craigleith Gardens  	 Friday
Craigleith Grove  	 Friday
Craigleith Hill  	 Friday
Craigleith Hill Avenue  	 Tuesday
Craigleith Hill Crescent  	 Tuesday
Craigleith Hill Gardens  	 Tuesday
Craigleith Hill Green  	 Tuesday
Craigleith Hill Grove  	 Tuesday
Craigleith Hill Loan  	 Tuesday
Craigleith Hill Park  	 Tuesday
Craigleith Hill Row  	 Tuesday
Craigleith Rise  	 Friday
Craigleith Road  	 Friday
Craigleith View  	 Friday
Craiglockhart Avenue  	 Wednesday
Craiglockhart Bank  	 Wednesday
Craiglockhart Crescent  	 Wednesday
Craiglockhart Dell Road  	 Wednesday
Craiglockhart Drive North  	 Wednesday
Craiglockhart Drive South  	 Wednesday
Craiglockhart Gardens  	 Wednesday
Craiglockhart Grove  	 Wednesday
Craiglockhart Loan  	 Wednesday
Craiglockhart Park  	 Wednesday
Craiglockhart Place  	 Wednesday
Craiglockhart Quadrant  	 Wednesday
Craiglockhart Road  	 Wednesday
Craiglockhart Road North  	 Wednesday
Craiglockhart Terrace  	 Wednesday
Craiglockhart View  	 Wednesday
Craigmillar Castle Avenue  	 Friday
Craigmillar Castle Gardens  	 Friday
Craigmillar Castle Loan  	 Friday
Craigmillar Castle Road  	 Friday
Craigmillar Park  	 Wednesday
Craigmount Avenue  	 Friday
Craigmount Avenue North  	 Friday
Craigmount Bank  	 Friday
Craigmount Bank West  	 Friday
Craigmount Brae  	 Friday
Craigmount Court  	 Friday
Craigmount Crescent  	 Friday
Craigmount Drive  	 Friday
Craigmount Gardens  	 Friday
Craigmount Grove  	 Friday
Craigmount Grove North  	 Friday
Craigmount Hill  	 Friday
Craigmount Loan  	 Friday
Craigmount Park  	 Friday
Craigmount Place  	 Friday
Craigmount Terrace  	 Friday
Craigmount View  	 Friday
Craigmount Way  	 Friday
Craigmuir Place  	 Tuesday
Craigour Avenue  	 Thursday
Craigour Crescent  	 Thursday
Craigour Drive  	 Thursday
Craigour Gardens  	 Thursday
Craigour Grove  	 Thursday
Craigour Loan  	 Thursday
Craigour Terrace  	 Thursday
Craigpark Avenue  	 Thursday
Craigpark Crescent  	 Thursday
Craigroyston Grove  	 Tuesday
Craigroyston Place  	 Tuesday
Craigs Avenue  	 Friday
Craigs Bank  	 Friday
Craigs Crescent  	 Friday
Craigs Drive  	 Thursday
Craigs Gardens  	 Friday
Craigs Grove  	 Friday
Craigs Loan  	 Friday
Craigs Park  	 Thursday
Cramond Avenue  	 Thursday
Cramond Bank  	 Thursday
Cramond Bridge  	 Thursday
Cramond Brig Toll  	 Thursday
Cramond Crescent  	 Thursday
Cramond Gardens  	 Thursday
Cramond Glebe Gardens  	 Thursday
Cramond Glebe Road  	 Thursday
Cramond Glebe Terrace  	 Thursday
Cramond Green  	 Thursday
Cramond Grove  	 Thursday
Cramond Park  	 Thursday
Cramond Place  	 Thursday
Cramond Regis  	 Thursday
Cramond Road South  	 Tuesday
Cramond Terrace  	 Thursday
Cramond Vale  	 Thursday
Cramond Village  	 Thursday
Crarae Avenue  	 Friday
Craw Yard Drive  	 Wednesday
Craw Yard Place  	 Wednesday
Craw'S Close  	 Thursday
Crawford Gait  	 Thursday
Crawford Green  	 Thursday
Crawfurd Road  	 Wednesday
Crewe Bank  	 Tuesday
Crewe Crescent  	 Tuesday
Crewe Grove  	 Tuesday
Crewe Loan  	 Tuesday
Crewe Place  	 Tuesday
Crewe Road Gardens  	 Tuesday
Crewe Road North  	 Tuesday
Crewe Road South  	 Tuesday
Crewe Road West  	 Tuesday
Crewe Terrace  	 Tuesday
Cromwell Place  	 Tuesday
Crookston Crescent  	 Thursday
Crosswood Avenue  	 Wednesday
Crosswood Crescent  	 Wednesday
Cullet Walk  	 Friday
Cumberland Street  	 Tuesday
Cumberland Street North East Lane  	 Tuesday
Cumberland Street North West Lane  	 Tuesday
Cumberland Street South East Lane  	 Tuesday
Cumberland Street South West Lane  	 Tuesday
Cumin Place  	 Wednesday
Cumlodden Avenue  	 Friday
Cumnor Crescent  	 Thursday
Cunningham Square  	 Friday
Curriehill Castle Drive  	 Wednesday
Curriehill Road  	 Wednesday
Currievale Drive  	 Wednesday
Currievale Farm  	 Wednesday
Currievale Park  	 Wednesday
Currievale Park Grove  	 Wednesday
Custom House Place  	 Tuesday
Daiches Braes  	 Friday
Daisy Terrace  	 Tuesday
Dalhousie Terrace  	 Wednesday
Dalkeith Road Mews  	 Friday
Dalkeith Street  	 Friday
Dalmahoy  	 Thursday
Dalmahoy Crescent  	 Wednesday
Dalmahoy Road  	 Thursday
Dalmeny Estate  	 Thursday
Dalmeny Road  	 Tuesday
Dalmeny Street  	 Tuesday
Dalry Road  	 Tuesday
Dalrymple Crescent  	 Wednesday
Damselfly Road  	 Thursday
Damselfly View  	 Thursday
Dania Court  	 Friday
Danube Street  	 Friday
Darnaway Street  	 Tuesday
Darnell Road  	 Tuesday
Darnley Terrace  	 Friday
Davidson Gardens  	 Tuesday
Davidson Park  	 Tuesday
Davidson Road  	 Tuesday
Davies Row  	 Wednesday
Daybell Loan  	 Thursday
Dean Bridge  	 Friday
Dean Park Crescent  	 Friday
Dean Park Mews  	 Friday
Dean Path  	 Friday
Dean Street  	 Friday
Dean Terrace  	 Friday
Deanery Close  	 Tuesday
Deanhaugh Street  	 Friday
Deanpark Avenue  	 Wednesday
Deanpark Bank  	 Wednesday
Deanpark Brae  	 Wednesday
Deanpark Court  	 Wednesday
Deanpark Crescent  	 Wednesday
Deanpark Gardens  	 Wednesday
Deanpark Grove  	 Wednesday
Deanpark Place  	 Wednesday
Deanpark Square  	 Wednesday
Dechmont Road  	 Thursday
Dell Road  	 Wednesday
Denham Green Avenue  	 Tuesday
Denham Green Place  	 Tuesday
Denham Green Terrace  	 Tuesday
Derby Street  	 Tuesday
Devon Gardens  	 Friday
Devon Place  	 Friday
Dewar Place Lane  	 Tuesday
Dick Place  	 Wednesday
Dimma Park  	 Thursday
Dinmont Drive  	 Friday
Dochart Drive  	 Friday
Dock Street  	 Tuesday
Dolphin Avenue  	 Wednesday
Dolphin Gardens East  	 Wednesday
Dolphin Gardens West  	 Wednesday
Dolphin Road  	 Wednesday
Donaldson Crescent  	 Friday
Dorset Place  	 Tuesday
Double Hedges Park  	 Friday
Double Hedges Road  	 Friday
Douglas Crescent  	 Friday
Douglas Gardens  	 Friday
Douglas Gardens Mews  	 Friday
Douglas Terrace  	 Tuesday
Doune Terrace  	 Tuesday
Dovecot Grove  	 Wednesday
Dovecot Loan  	 Wednesday
Dovecot Park  	 Wednesday
Dovecot Road  	 Wednesday
Dowies Mill Lane  	 Thursday
Downie Grove  	 Friday
Downie Terrace  	 Friday
Dreghorn Drive  	 Thursday
Dreghorn Gardens  	 Thursday
Dreghorn Grove  	 Thursday
Dreghorn Link  	 Thursday
Dreghorn Loan  	 Wednesday
Dreghorn Park  	 Wednesday
Dreghorn Place  	 Thursday
Drum Avenue  	 Thursday
Drum Brae Avenue  	 Friday
Drum Brae Crescent  	 Thursday
Drum Brae Gardens  	 Friday
Drum Brae Grove  	 Thursday
Drum Brae Neuk  	 Friday
Drum Brae Park  	 Friday
Drum Brae Park Approach  	 Friday
Drum Brae Place  	 Friday
Drum Brae South  	 Friday
Drum Brae Terrace  	 Thursday
Drum Brae Walk  	 Friday
Drum Cottages  	 Thursday
Drum Crescent  	 Thursday
Drum Place  	 Thursday
Drum Street  	 Thursday
Drum Woods  	 Thursday
Drummond Place  	 Tuesday
Drumsheugh Gardens  	 Friday
Drumsheugh Place  	 Friday
Dryden Gait  	 Tuesday
Dryden Gardens  	 Tuesday
Dryden Place  	 Friday
Dryden Street  	 Tuesday
Dryden Terrace  	 Tuesday
Drylaw Avenue  	 Tuesday
Drylaw Crescent  	 Tuesday
Drylaw Gardens  	 Tuesday
Drylaw Green  	 Tuesday
Drylaw Grove  	 Tuesday
Drylaw House Gardens  	 Tuesday
Drylaw House Paddock  	 Tuesday
Duart Crescent  	 Friday
Dublin Meuse  	 Tuesday
Dublin Street  	 Tuesday
Dublin Street Lane North  	 Tuesday
Dublin Street Lane South  	 Tuesday
Duddingston Avenue  	 Friday
Duddingston Crescent  	 Friday
Duddingston Gardens North  	 Friday
Duddingston Gardens South  	 Friday
Duddingston Grove East  	 Friday
Duddingston Grove West  	 Friday
Duddingston Loan  	 Friday
Duddingston Mains Cottages  	 Friday
Duddingston Mills  	 Friday
Duddingston Park  	 Friday
Duddingston Park South  	 Friday
Duddingston Rise  	 Friday
Duddingston Road  	 Friday
Duddingston Road West  	 Friday
Duddingston Row  	 Friday
Duddingston Square East  	 Friday
Duddingston Square West  	 Friday
Duddingston View  	 Friday
Dudgeon Place  	 Thursday
Dudley Avenue  	 Tuesday
Dudley Avenue South  	 Tuesday
Dudley Bank  	 Tuesday
Dudley Crescent  	 Tuesday
Dudley Gardens  	 Tuesday
Dudley Grove  	 Tuesday
Dudley Terrace  	 Tuesday
Duke'S Walk  	 Friday
Dumbeg Park  	 Wednesday
Dumbryden Drive  	 Wednesday
Dumbryden Gardens  	 Wednesday
Duncan Street  	 Friday
Duncombe Road  	 Wednesday
Dundas Avenue  	 Thursday
Dundas Estate  	 Thursday
Dundas Home Farm  	 Thursday
Dundas Place  	 Thursday
Dundas Street  	 Tuesday
Dundee Terrace  	 Tuesday
Dundrennan Cottages  	 Friday
Dunedin Street  	 Tuesday
Dunipace Road  	 Wednesday
Dunkeld Street  	 Friday
Dunkirk Road  	 Friday
Dunlaw Wynd  	 Thursday
Dunnet Grove  	 Thursday
Dunnikier Lane  	 Thursday
Dunnikier Way  	 Thursday
Dunollie Court  	 Thursday
Dunrobin Place  	 Tuesday
Dunsmuir Court  	 Wednesday
Duntreath Crescent  	 Friday
Duntreath Place  	 Friday
Duntreath Road  	 Friday
Duntreath Terrace  	 Friday
Dunvegan Court  	 Thursday
Durar Drive  	 Friday
Durham Avenue  	 Friday
Durham Drive  	 Friday
Durham Gardens North  	 Friday
Durham Gardens South  	 Friday
Durham Grove  	 Friday
Durham Place East  	 Friday
Durham Road  	 Friday
Durham Road South  	 Friday
Durham Square  	 Friday
Durham Terrace  	 Friday
Durie Loan  	 Thursday
Durward Grove  	 Friday
Earl Grey Street  	 Tuesday
Earl Haig Gardens  	 Tuesday
East Adam Street  	 Wednesday
East Barnton Avenue  	 Tuesday
East Barnton Gardens  	 Tuesday
East Briggers Brae  	 Thursday
East Brighton Crescent  	 Friday
East Broughton Place  	 Tuesday
East Caiystane Place  	 Thursday
East Caiystane Road  	 Thursday
East Camus Place  	 Thursday
East Castle Road  	 Wednesday
East Champanyie  	 Wednesday
East Clapperfield  	 Friday
East Claremont Street  	 Tuesday
East Comiston  	 Thursday
East Craigs Rigg  	 Thursday
East Craigs Wynd  	 Thursday
East Croft  	 Thursday
East Farm Of Gilmerton  	 Thursday
East Hannahfield  	 Wednesday
East Hermiston  	 Wednesday
East Hermitage Place  	 Tuesday
East Kilngate Place  	 Thursday
East Kilngate Rigg  	 Thursday
East Kilngate Wynd  	 Thursday
East Lillypot  	 Tuesday
East London Street  	 Tuesday
East Mayfield  	 Friday
East Newington Place  	 Friday
East Parkside  	 Friday
East Pilton Farm Crescent  	 Tuesday
East Pilton Farm Wynd  	 Tuesday
East Restalrig Terrace  	 Tuesday
East Rigg Farm  	 Wednesday
East Rigg Farm  	 Thursday
East Savile Road  	 Wednesday
East Suffolk Park  	 Wednesday
East Suffolk Road  	 Wednesday
East Terrace  	 Thursday
East Trinity Road  	 Tuesday
East Werberside  	 Tuesday
East Werberside Place  	 Tuesday
Easter Belmont Road  	 Friday
Easter Currie Court  	 Wednesday
Easter Currie Crescent  	 Wednesday
Easter Currie Place  	 Wednesday
Easter Currie Terrace  	 Wednesday
Easter Dalmeny  	 Thursday
Easter Dalmeny Cottages  	 Thursday
Easter Drylaw Avenue  	 Tuesday
Easter Drylaw Bank  	 Tuesday
Easter Drylaw Drive  	 Tuesday
Easter Drylaw Gardens  	 Tuesday
Easter Drylaw Grove  	 Tuesday
Easter Drylaw Loan  	 Tuesday
Easter Drylaw Place  	 Tuesday
Easter Drylaw View  	 Tuesday
Easter Drylaw Way  	 Tuesday
Easter Hermitage  	 Tuesday
Easter Park Drive  	 Tuesday
Easter Road  	 Tuesday
Easter Steil  	 Wednesday
Easter Warriston  	 Tuesday
Eastfield  	 Friday
Eastfield Gardens  	 Friday
Eastfield Place  	 Friday
Eastfield Road  	 Thursday
Echline  	 Thursday
Echline Drive  	 Thursday
Echline Gardens  	 Thursday
Echline Green  	 Thursday
Echline Grove  	 Thursday
Echline Park  	 Thursday
Echline Place  	 Thursday
Echline Terrace  	 Thursday
Echline View  	 Thursday
Eden Lane  	 Wednesday
Eden Terrace  	 Wednesday
Edgelaw Rigg  	 Thursday
Edinburgh Road  	 Thursday
Edwards Wynd  	 Thursday
Egan Terrace  	 Friday
Eglinton Crescent  	 Friday
Egypt Mews  	 Wednesday
Eildon Street  	 Tuesday
Eildon Terrace  	 Tuesday
Eilston Drive  	 Thursday
Eilston Loan  	 Thursday
Eilston Road  	 Thursday
Eilston Terrace  	 Thursday
Elbe Street  	 Tuesday
Elcho Terrace  	 Friday
Electra Place  	 Friday
Elgin Street  	 Tuesday
Eliza Wigham Bow  	 Thursday
Eliza Wigham Place  	 Thursday
Ellangowan Terrace  	 Friday
Ellen'S Glen Loan  	 Thursday
Ellen'S Glen Road  	 Thursday
Ellersly Road  	 Friday
Elliot Gardens  	 Wednesday
Elliot Park  	 Wednesday
Elliot Place  	 Wednesday
Elliot Road  	 Wednesday
Ellis Drive  	 Friday
Ellis Street  	 Thursday
Elm Place  	 Tuesday
Elmwood Terrace  	 Tuesday
Eltringham Gardens  	 Friday
Eltringham Grove  	 Friday
Eltringham Terrace  	 Friday
Erica Row  	 Tuesday
Erica Walk  	 Tuesday
Erroll Drive  	 Friday
Esdaile Bank  	 Wednesday
Esdaile Park  	 Wednesday
Esdaile Park  	 Thursday
Esplanade Terrace  	 Friday
Essendean Place  	 Friday
Essex Brae  	 Thursday
Essex Park  	 Thursday
Essex Road  	 Thursday
Esslemont Road  	 Wednesday
Ethel Terrace  	 Wednesday
Eton Terrace  	 Friday
Ettrick Grove  	 Wednesday
Ettrick Loan  	 Wednesday
Ettrick Road  	 Wednesday
Ettrickdale Place  	 Tuesday
Eva Place  	 Wednesday
Ewerland  	 Thursday
Eyre Crescent  	 Tuesday
Eyre Place  	 Tuesday
Eyre Place Lane  	 Tuesday
Eyre Terrace  	 Tuesday
Fair-A-Far  	 Thursday
Fair-A-Far Shot  	 Thursday
Fairbairn Street  	 Wednesday
Fairbrae  	 Friday
Fairfield Gardens  	 Thursday
Fairford Gardens  	 Friday
Fairholm Mews  	 Wednesday
Fairley Wynd  	 Thursday
Fairmile Avenue  	 Thursday
Fala Place  	 Thursday
Falkland Gardens  	 Friday
Farquhar Terrace  	 Thursday
Farrer Grove  	 Tuesday
Farrer Terrace  	 Tuesday
Fauldburn  	 Thursday
Fauldburn Park  	 Thursday
Featherhall Avenue  	 Wednesday
Featherhall Crescent North  	 Wednesday
Featherhall Crescent South  	 Wednesday
Featherhall Grove  	 Wednesday
Featherhall Place  	 Wednesday
Featherhall Road  	 Wednesday
Featherhall Terrace  	 Wednesday
Ferguson Rigg  	 Friday
Fernieflat Neuk  	 Wednesday
Ferniehill Avenue  	 Thursday
Ferniehill Drive  	 Thursday
Ferniehill Gardens  	 Thursday
Ferniehill Grove  	 Thursday
Ferniehill Place  	 Thursday
Ferniehill Road  	 Thursday
Ferniehill Square  	 Thursday
Ferniehill Street  	 Thursday
Ferniehill Terrace  	 Thursday
Ferniehill Way  	 Thursday
Fernielaw Avenue  	 Wednesday
Fernieside Avenue  	 Thursday
Fernieside Crescent  	 Thursday
Fernieside Drive  	 Thursday
Fernieside Gardens  	 Thursday
Fernieside Grove  	 Thursday
Fernieside Place  	 Thursday
Ferry Gait Drive  	 Tuesday
Ferry Gait Gardens  	 Tuesday
Ferry Gait Walk  	 Tuesday
Ferry Road  	 Tuesday
Ferry Road Avenue  	 Tuesday
Ferry Road Drive  	 Tuesday
Ferry Road Gardens  	 Tuesday
Ferry Road Grove  	 Tuesday
Ferry Road Place  	 Tuesday
Ferryburn  	 Thursday
Ferryburn Green  	 Thursday
Ferryfield  	 Tuesday
Ferrymuir Gait  	 Thursday
Ferrymuir Lane  	 Thursday
Fettes Rise  	 Tuesday
Fettes Row  	 Tuesday
Figgate Lane  	 Friday
Figgate Street  	 Friday
Fillyside Avenue  	 Tuesday
Fillyside Road  	 Tuesday
Fillyside Terrace  	 Tuesday
Findhorn Place  	 Wednesday
Findlay Avenue  	 Tuesday
Findlay Cottages  	 Tuesday
Findlay Gardens  	 Tuesday
Findlay Grove  	 Tuesday
Findlay Medway  	 Tuesday
Fingal Place  	 Wednesday
Fingzies Place  	 Tuesday
Finlaggan Court  	 Thursday
Fireclay Walk  	 Friday
Firrhill Crescent  	 Wednesday
Firrhill Drive  	 Wednesday
Firrhill Loan  	 Wednesday
Firrhill Neuk  	 Wednesday
Firrhill Park  	 Wednesday
Fisher Place  	 Thursday
Fishmarket Square  	 Tuesday
Fishwives Causeway  	 Friday
Fleming Place  	 Tuesday
Flint Terrace  	 Friday
Flockhart Gait  	 Friday
Forbes Road  	 Wednesday
Forbes Street  	 Wednesday
Ford'S Road  	 Friday
Fordell Road  	 Thursday
Forres Street  	 Tuesday
Forrester Park Avenue  	 Wednesday
Forrester Park Drive  	 Wednesday
Forrester Park Gardens  	 Wednesday
Forrester Park Green  	 Wednesday
Forrester Park Grove  	 Wednesday
Forrester Park Loan  	 Wednesday
Forrester Road  	 Friday
Forth Park  	 Thursday
Forth Place  	 Thursday
Forth Street  	 Tuesday
Forth Terrace  	 Thursday
Forth View Avenue  	 Wednesday
Forth View Crescent  	 Wednesday
Forth View Road  	 Wednesday
Forthview Road  	 Tuesday
Forthview Terrace  	 Tuesday
Foulis Crescent  	 Wednesday
Fountainhall Road  	 Wednesday
Fox Covert Avenue  	 Friday
Fox Covert Grove  	 Friday
Fox Spring Crescent  	 Thursday
Fox Spring Rise  	 Thursday
Foxhall  	 Thursday
Foxhall Gait  	 Thursday
Foxhall View  	 Thursday
Francis Place  	 Thursday
Fraser Avenue  	 Tuesday
Fraser Crescent  	 Tuesday
Fraser Gardens  	 Tuesday
Fraser Grove  	 Tuesday
Freelands Road  	 Thursday
Freelands Way  	 Thursday
Friars Croft Road  	 Thursday
Friary Road  	 Friday
Frogston Avenue  	 Thursday
Frogston Gardens  	 Thursday
Frogston Grove  	 Thursday
Frogston Road East  	 Thursday
Frogston Road West  	 Thursday
Frogston Terrace  	 Thursday
Furcheons Park  	 Friday
Fyfe Way  	 Thursday
Galachlaw Shot  	 Thursday
Galachlawside  	 Thursday
Galvane Road  	 Friday
Gamekeeper'S Loan  	 Thursday
Gamekeeper'S Park  	 Thursday
Gamekeeper'S Road  	 Thursday
Garden Terrace  	 Tuesday
Gardiner Grove  	 Friday
Gardiner Road  	 Friday
Gardiner Terrace  	 Friday
Garscube Terrace  	 Friday
Garvald Street  	 Thursday
Gaskell Street  	 Wednesday
Gayfield Close  	 Tuesday
Gayfield Place  	 Tuesday
Gayfield Place Lane  	 Tuesday
Gayfield Square  	 Tuesday
Gayfield Street  	 Tuesday
George Square  	 Wednesday
Gifford Crescent  	 Wednesday
Gilberstoun  	 Friday
Gilberstoun Brig  	 Friday
Gilberstoun Loan  	 Friday
Gilberstoun Place  	 Friday
Gilberstoun Wynd  	 Friday
Giles Street  	 Tuesday
Gillerhill  	 Thursday
Gillespie Road  	 Wednesday
Gillespie Street  	 Tuesday
Gillon Drive  	 Wednesday
Gillsland Park  	 Wednesday
Gillsland Road  	 Wednesday
Gilmerton Dykes Avenue  	 Thursday
Gilmerton Dykes Crescent  	 Thursday
Gilmerton Dykes Drive  	 Thursday
Gilmerton Dykes Gardens  	 Thursday
Gilmerton Dykes Grove  	 Thursday
Gilmerton Dykes Loan  	 Thursday
Gilmerton Dykes Place  	 Thursday
Gilmerton Dykes Road  	 Thursday
Gilmerton Dykes Street  	 Thursday
Gilmerton Dykes Terrace  	 Thursday
Gilmerton Dykes View  	 Thursday
Gilmerton Place  	 Thursday
Gilmerton Station Road  	 Thursday
Gilmore Place  	 Tuesday
Gilmour Road  	 Wednesday
Gilroy Road  	 Tuesday
Gladhouse Place  	 Thursday
Gladstone Terrace  	 Wednesday
Glasgow Road  	 Thursday
Glebe Gardens  	 Friday
Glebe Grove  	 Friday
Glebe Road  	 Friday
Glebe Terrace  	 Friday
Glenallan Drive  	 Friday
Glenallan Loan  	 Friday
Glenalmond Place  	 Wednesday
Glenarm Place  	 Tuesday
Glenbrook  	 Wednesday
Glenbrook Road  	 Wednesday
Glencairn Crescent  	 Friday
Glendevon Avenue  	 Friday
Glendevon Gardens  	 Friday
Glendevon Grove  	 Friday
Glendevon Park  	 Friday
Glendevon Place  	 Friday
Glendevon Road  	 Friday
Glendevon Terrace  	 Friday
Glendinning Crescent  	 Thursday
Glendinning Drive  	 Thursday
Glendinning Place  	 Thursday
Glendinning Road  	 Thursday
Glendinning Way  	 Thursday
Glenfinlas Street  	 Tuesday
Glenisla Gardens  	 Wednesday
Glenisla Gardens Lane  	 Wednesday
Glenlea Cottages  	 Friday
Glenlee Avenue  	 Friday
Glenlee Gardens  	 Friday
Glenlockhart Bank  	 Wednesday
Glenlockhart Road  	 Wednesday
Glenlockhart Valley  	 Wednesday
Glennie Road  	 Friday
Glenogle House  	 Tuesday
Glenogle Place  	 Tuesday
Glenogle Road  	 Tuesday
Glenogle Road  	 Thursday
Glenogle Terrace  	 Tuesday
Glenorchy Terrace  	 Wednesday
Glenure Loan  	 Friday
Glenvarloch Crescent  	 Thursday
Gloucester Lane  	 Tuesday
Gloucester Place  	 Tuesday
Gloucester Square  	 Tuesday
Goff Avenue  	 Tuesday
Gogar Station Road  	 Wednesday
Gogarbank  	 Wednesday
Gogarloch Bank  	 Wednesday
Gogarloch Haugh  	 Wednesday
Gogarloch Muir  	 Wednesday
Gogarloch Road  	 Wednesday
Gogarloch Syke  	 Wednesday
Gogarmuir Road  	 Wednesday
Gogarstone Road  	 Thursday
Goldenacre Terrace  	 Tuesday
Goldeneye Drive  	 Thursday
Goldeneye Gait  	 Thursday
Goldenrod Street  	 Friday
Goodtrees Gardens  	 Thursday
Goodtrees Terrace  	 Thursday
Gordon Loan  	 Friday
Gordon Road  	 Friday
Gordon Street  	 Tuesday
Gordon Terrace  	 Wednesday
Gorgie Park Close  	 Friday
Gorgie Road  	 Friday
Gowanhill Farm Road  	 Wednesday
Gracemount Avenue  	 Thursday
Gracemount Drive  	 Thursday
Gracemount House Drive  	 Thursday
Gracemount Place  	 Thursday
Gracemount Road  	 Thursday
Gracemount Square  	 Thursday
Granby Road  	 Wednesday
Grandfield  	 Tuesday
Grandison Drive  	 Thursday
Grandville  	 Tuesday
Grange Crescent  	 Wednesday
Grange Loan  	 Wednesday
Grange Loan Gardens  	 Wednesday
Grange Road  	 Wednesday
Grange Terrace  	 Wednesday
Grant Avenue  	 Wednesday
Granton Crescent  	 Tuesday
Granton Gardens  	 Tuesday
Granton Grove  	 Tuesday
Granton Mains Avenue  	 Tuesday
Granton Mains Bank  	 Tuesday
Granton Mains Brae  	 Tuesday
Granton Mains Court  	 Tuesday
Granton Mains East  	 Tuesday
Granton Mains Gait  	 Tuesday
Granton Mains Vale  	 Tuesday
Granton Mains Wynd  	 Tuesday
Granton Medway  	 Tuesday
Granton Mill Crescent  	 Tuesday
Granton Mill Drive  	 Tuesday
Granton Mill March  	 Tuesday
Granton Mill Park  	 Tuesday
Granton Mill Place  	 Tuesday
Granton Mill Road  	 Tuesday
Granton Mill West  	 Tuesday
Granton Park Avenue  	 Tuesday
Granton Park Avenue North  	 Tuesday
Granton Place  	 Tuesday
Granton Road  	 Tuesday
Granton Square  	 Tuesday
Granton Terrace  	 Tuesday
Granton View  	 Tuesday
Grantully Place  	 Friday
Granville Terrace  	 Tuesday
Grassie Avenue  	 Friday
Gray'S Loan  	 Wednesday
Great Carleton Place  	 Friday
Great Carleton Square  	 Friday
Great King Street  	 Tuesday
Great Stuart Street  	 Tuesday
Greenbank Avenue  	 Wednesday
Greenbank Crescent  	 Wednesday
Greenbank Drive  	 Wednesday
Greenbank Gardens  	 Wednesday
Greenbank Grove  	 Wednesday
Greenbank Lane  	 Wednesday
Greenbank Loan  	 Wednesday
Greenbank Park  	 Wednesday
Greenbank Place  	 Wednesday
Greenbank Rise  	 Wednesday
Greenbank Road  	 Wednesday
Greenbank Row  	 Wednesday
Greenbank Terrace  	 Wednesday
Greencraig Drive  	 Thursday
Greendale Park  	 Tuesday
Greendykes Road  	 Friday
Greenend Drive  	 Thursday
Greenend Gardens  	 Thursday
Greenend Grove  	 Thursday
Greenfield Crescent  	 Wednesday
Greenfield Road  	 Wednesday
Greenhill Court  	 Wednesday
Greenhill Gardens  	 Wednesday
Greenhill Park  	 Wednesday
Greenhill Place  	 Wednesday
Greenhill Terrace  	 Wednesday
Greenlaw Hedge  	 Wednesday
Greenlaw Rig  	 Wednesday
Greenmantle Loan  	 Thursday
Greenpark  	 Thursday
Greenstone Loan  	 Thursday
Greenwell Wynd  	 Thursday
Greenwood Close  	 Friday
Gretna Mews  	 Tuesday
Grierson Avenue  	 Tuesday
Grierson Crescent  	 Tuesday
Grierson Gardens  	 Tuesday
Grierson Road  	 Tuesday
Grierson Square  	 Tuesday
Grierson Villas  	 Tuesday
Grieve Crescent  	 Tuesday
Griffin Road  	 Tuesday
Grigor Avenue  	 Tuesday
Grigor Drive  	 Tuesday
Grigor Gardens  	 Tuesday
Grigor Terrace  	 Tuesday
Groathill Avenue  	 Tuesday
Groathill Gardens East  	 Tuesday
Groathill Gardens West  	 Tuesday
Groathill Loan  	 Tuesday
Groathill Road North  	 Tuesday
Groathill Road South  	 Tuesday
Grosvenor Crescent  	 Tuesday
Grosvenor Gardens  	 Friday
Grosvenor Street  	 Tuesday
Grove Street  	 Tuesday
Grubb Gardens  	 Thursday
Grundieswell Road  	 Thursday
Guardhouse Parade  	 Tuesday
Guardianswood  	 Friday
Guardwell Crescent  	 Thursday
Guardwell Glen  	 Thursday
Gulliver Street  	 Friday
Gyle Park Gardens  	 Thursday
Gylemuir Road  	 Wednesday
Haddington Place  	 Tuesday
Hadley Terrace  	 Wednesday
Haggs Farm Road  	 Thursday
Hailes Approach  	 Wednesday
Hailes Avenue  	 Wednesday
Hailes Bank  	 Wednesday
Hailes Crescent  	 Wednesday
Hailes Gardens  	 Wednesday
Hailes Grove  	 Wednesday
Hailes Park  	 Wednesday
Hailes Street  	 Tuesday
Hailes Terrace  	 Wednesday
Hailesland Gardens  	 Wednesday
Hailesland Grove  	 Wednesday
Hailesland Place  	 Wednesday
Hailesland Road  	 Wednesday
Hainburn Park  	 Thursday
Hall Terrace  	 Wednesday
Hallcroft Close  	 Thursday
Hallcroft Crescent  	 Thursday
Hallcroft Gardens  	 Thursday
Hallcroft Green  	 Thursday
Hallcroft Neuk  	 Thursday
Hallcroft Park  	 Thursday
Hallcroft Rise  	 Thursday
Hallhead Road  	 Wednesday
Hallyards Road  	 Thursday
Hamilton Drive  	 Friday
Hamilton Drive West  	 Friday
Hamilton Gardens  	 Friday
Hamilton Grove  	 Friday
Hamilton Park  	 Friday
Hamilton Terrace  	 Friday
Hamilton Wynd  	 Tuesday
Hamilton'S Close  	 Thursday
Hamilton'S Folly Mews  	 Wednesday
Hammond Place  	 Friday
Hampton Place  	 Friday
Hampton Terrace  	 Friday
Hapland Bow  	 Thursday
Harbour Lane  	 Thursday
Harbour Place  	 Friday
Harden Place  	 Wednesday
Harelaw Road  	 Wednesday
Harewood Crescent  	 Friday
Harewood Drive  	 Friday
Harewood Road  	 Friday
Harlaw Bank  	 Wednesday
Harlaw Gait  	 Wednesday
Harlaw March  	 Wednesday
Harlaw Road  	 Wednesday
Harper Place  	 Thursday
Harperrig Way  	 Wednesday
Harrismith Place  	 Tuesday
Harrison Road  	 Tuesday
Hart Street  	 Tuesday
Hartington Gardens  	 Tuesday
Hartington Place  	 Tuesday
Harvest Road  	 Thursday
Harvest Wynd  	 Thursday
Harvesters Way  	 Wednesday
Hatton Place  	 Wednesday
Haugh Park  	 Wednesday
Haugh Street  	 Friday
Haughhead Farm  	 Wednesday
Haven Lane  	 Tuesday
Havenfield Mews  	 Friday
Hawes Brae  	 Thursday
Hawkhead Crescent  	 Thursday
Hawkhead Grove  	 Thursday
Hawkhill  	 Tuesday
Hawkhill Avenue  	 Tuesday
Hawthorn Place  	 Thursday
Hawthornbank Lane  	 Friday
Hawthornbank Place  	 Tuesday
Hawthornbank Terrace  	 Tuesday
Hay Avenue  	 Friday
Hay Drive  	 Friday
Hay Gardens  	 Friday
Hay Place  	 Friday
Hay Terrace  	 Friday
Hayfield  	 Thursday
Haymarket Terrace  	 Friday
Haystack Park  	 Wednesday
Hazelbank Terrace  	 Tuesday
Hazeldean Terrace  	 Friday
Hazelwood Grove  	 Friday
Headrigg Row  	 Friday
Heath Road  	 Tuesday
Heath Walk  	 Tuesday
Hedgehog Crescent  	 Thursday
Hedgehog Walk  	 Thursday
Helen Crummy Way  	 Friday
Henderland Road  	 Friday
Henderson Row  	 Tuesday
Henderson Terrace  	 Tuesday
Henry Ross Place  	 Thursday
Hepburn Crescent  	 Thursday
Herdrigg Place  	 Thursday
Heriot Row  	 Tuesday
Hermiston  	 Wednesday
Hermiston Steading  	 Wednesday
Hermitage Drive  	 Wednesday
Hermitage Gardens  	 Wednesday
Hermitage Park  	 Tuesday
Hermitage Park Grove  	 Tuesday
Hermitage Park Lea  	 Tuesday
Hermitage Park South  	 Tuesday
Hermitage Place  	 Tuesday
Hermitage Terrace  	 Wednesday
Hermits Croft  	 Wednesday
Hewing Place  	 Friday
Hewlett Way  	 Thursday
Hewson Way  	 Friday
Hibbert Street  	 Thursday
High Buckstone  	 Thursday
High Riggs  	 Tuesday
Highlea Circle  	 Wednesday
Highlea Grove  	 Wednesday
Hill Place  	 Wednesday
Hill Square  	 Wednesday
Hillcoat Loan  	 Friday
Hillcoat Place  	 Friday
Hillhouse Road  	 Tuesday
Hillpark Avenue  	 Tuesday
Hillpark Brae  	 Friday
Hillpark Court  	 Tuesday
Hillpark Crescent  	 Tuesday
Hillpark Drive  	 Tuesday
Hillpark Gardens  	 Tuesday
Hillpark Green  	 Friday
Hillpark Grove  	 Tuesday
Hillpark Loan  	 Tuesday
Hillpark Rise  	 Tuesday
Hillpark Road  	 Tuesday
Hillpark Terrace  	 Friday
Hillpark Way  	 Tuesday
Hillpark Wood  	 Tuesday
Hillside Road  	 Thursday
Hillside Terrace  	 Thursday
Hillview  	 Tuesday
Hillview Cottages  	 Thursday
Hillview Crescent  	 Friday
Hillview Drive  	 Friday
Hillview Road  	 Friday
Hillview Terrace  	 Friday
Hillwood Avenue  	 Thursday
Hillwood Crescent  	 Thursday
Hillwood Gardens  	 Thursday
Hillwood Place  	 Thursday
Hillwood Rise  	 Thursday
Hillwood Road  	 Thursday
Hillwood Terrace  	 Thursday
Hoffmann Place  	 Friday
Hollybank Terrace  	 Tuesday
Holyrood Park Road  	 Friday
Hope Lane  	 Friday
Hope Lane North  	 Friday
Hope Park Terrace  	 Wednesday
Hope Terrace  	 Wednesday
Hopefield Terrace  	 Tuesday
Hopetoun Road  	 Thursday
Hopetoun Street  	 Tuesday
Hopper Gardens  	 Friday
Horsburgh Bank  	 Wednesday
Horsburgh Gardens  	 Wednesday
Horsburgh Grove  	 Wednesday
Hoseason Gardens  	 Friday
Hosie Rigg  	 Friday
House O'Hill Avenue  	 Tuesday
House O'Hill Brae  	 Tuesday
House O'Hill Crescent  	 Tuesday
House O'Hill Gardens  	 Tuesday
House O'Hill Green  	 Tuesday
House O'Hill Grove  	 Tuesday
House O'Hill Place  	 Tuesday
House O'Hill Road  	 Tuesday
House O'Hill Row  	 Tuesday
House O'Hill Terrace  	 Tuesday
Housefield Drive  	 Thursday
Howard Place  	 Tuesday
Howard Street  	 Tuesday
Howden Hall Court  	 Thursday
Howden Hall Crescent  	 Thursday
Howden Hall Drive  	 Thursday
Howden Hall Gardens  	 Thursday
Howden Hall Loan  	 Thursday
Howden Hall Park  	 Thursday
Howden Hall Road  	 Thursday
Howden Hall Way  	 Thursday
Howe Park  	 Thursday
Howe Street  	 Tuesday
Hugh Miller Place  	 Tuesday
Hugh Russell Place  	 Thursday
Humbie Farm Road  	 Thursday
Humbie Road  	 Thursday
Huntingdon Place  	 Tuesday
Hutchison Avenue  	 Friday
Hutchison Cottages  	 Friday
Hutchison Crossway  	 Friday
Hutchison Gardens  	 Friday
Hutchison Grove  	 Friday
Hutchison Loan  	 Friday
Hutchison Medway  	 Friday
Hutchison Park  	 Friday
Hutchison Place  	 Friday
Hutchison Road  	 Friday
Hutchison Terrace  	 Friday
Hutchison View  	 Friday
Hyvot Avenue  	 Thursday
Hyvot Bank Avenue  	 Thursday
Hyvot Court  	 Thursday
Hyvot Gardens  	 Thursday
Hyvot Green  	 Thursday
Hyvot Grove  	 Thursday
Hyvot Loan  	 Thursday
Hyvot Mill Drive  	 Thursday
Hyvot Mill Road  	 Thursday
Hyvot Park  	 Thursday
Inchcolm Terrace  	 Thursday
Inchgarvie Park  	 Thursday
Inchkeith Avenue  	 Thursday
Inchview Terrace  	 Tuesday
India Street  	 Tuesday
Industrial Road  	 Tuesday
Industry Home  	 Tuesday
Industry Lane  	 Tuesday
Inglewood Place  	 Thursday
Inglis Green Rigg  	 Wednesday
Inglis Green Road  	 Wednesday
Ingliston Gardens  	 Thursday
Ingliston Interchange  	 Thursday
Innes Crescent  	 Thursday
Innes Gait  	 Thursday
Inveralmond Drive  	 Thursday
Inveralmond Gardens  	 Thursday
Inveralmond Grove  	 Thursday
Inverleith Avenue  	 Tuesday
Inverleith Avenue South  	 Tuesday
Inverleith Gardens  	 Tuesday
Inverleith Grove  	 Tuesday
Inverleith Place  	 Tuesday
Inverleith Place Lane  	 Tuesday
Inverleith Row  	 Tuesday
Inverleith Terrace  	 Tuesday
Inverleith Terrace Lane  	 Tuesday
Ivanhoe Crescent  	 Thursday
Ivy Terrace  	 Tuesday
Jamaica Street North Lane  	 Tuesday
Jamaica Street South Lane  	 Tuesday
James Gall Wynd  	 Wednesday
James Street  	 Friday
Jane Smeal Crescent  	 Thursday
Jane Smeal Lane  	 Thursday
Jane Street  	 Tuesday
Jansch Place  	 Tuesday
Jardine Place  	 Friday
Jeffrey Avenue  	 Friday
Jeffrey Street  	 Wednesday
Jessfield Terrace  	 Tuesday
John Mason Court  	 Thursday
John Street  	 Friday
John Street Lane East  	 Friday
John Street Lane West  	 Friday
John'S Gardens  	 Friday
John'S Gardens  	 Thursday
John'S Place  	 Tuesday
John'S Place  	 Thursday
Johnsburn Green  	 Wednesday
Johnsburn Haugh  	 Wednesday
Johnsburn Park  	 Wednesday
Johnsburn Road  	 Wednesday
Joppa Gardens  	 Friday
Joppa Grove  	 Friday
Joppa Pans  	 Friday
Joppa Park  	 Friday
Joppa Road  	 Friday
Joppa Station Place  	 Friday
Joppa Terrace  	 Friday
Jordan Lane  	 Wednesday
Jordan Lane  	 Thursday
Junction Place  	 Tuesday
Juniper Avenue  	 Wednesday
Juniper Gardens  	 Wednesday
Juniper Grove  	 Wednesday
Juniper Lane  	 Wednesday
Juniper Park Road  	 Wednesday
Juniper Place  	 Wednesday
Juniper Terrace  	 Wednesday
Juniperlee  	 Wednesday
Kaimes Road  	 Friday
Kane Wynd  	 Friday
Katesmill Road  	 Wednesday
Keith Crescent  	 Friday
Keith Row  	 Friday
Keith Terrace  	 Friday
Kekewich Avenue  	 Tuesday
Kelly Place  	 Friday
Kemp Place  	 Tuesday
Kempsel Grove  	 Wednesday
Kempston Place  	 Thursday
Kenmure Avenue  	 Friday
Kestrel Avenue  	 Thursday
Kestrel Gardens  	 Thursday
Kew Terrace  	 Friday
Kidlaw Close  	 Thursday
Kilchurn Court  	 Thursday
Kilgours Bow  	 Friday
Kilgraston Road  	 Wednesday
Killiekrankies Path  	 Thursday
Kilmaurs Road  	 Friday
Kilmaurs Terrace  	 Friday
Kilmorey Place  	 Thursday
Kilngate Brae  	 Thursday
Kimmerghame Drive  	 Tuesday
Kimmerghame Loan  	 Tuesday
Kimmerghame Place  	 Tuesday
Kimmerghame Row  	 Tuesday
Kimmerghame View  	 Tuesday
Kinellan Gardens  	 Friday
Kinellan Road  	 Friday
King Edward'S Way  	 Thursday
King Malcolm Close  	 Thursday
King'S Cramond  	 Thursday
King'S Haugh  	 Friday
King'S Meadow  	 Friday
King'S Road  	 Tuesday
King'S Stables Road  	 Tuesday
Kinghorn Place  	 Tuesday
Kings View Crescent  	 Thursday
Kingsburgh Road  	 Friday
Kingsknowe Avenue  	 Wednesday
Kingsknowe Crescent  	 Wednesday
Kingsknowe Drive  	 Wednesday
Kingsknowe Gardens  	 Wednesday
Kingsknowe Grove  	 Wednesday
Kingsknowe Park  	 Wednesday
Kingsknowe Place  	 Wednesday
Kingsknowe Road North  	 Wednesday
Kingsknowe Road South  	 Wednesday
Kingsknowe Terrace  	 Wednesday
Kingston Avenue  	 Friday
Kinleith Mill Road  	 Wednesday
Kinloch Road  	 Thursday
Kinnear Rise  	 Tuesday
Kinnear Road  	 Tuesday
Kirk Brae  	 Thursday
Kirk Cramond  	 Thursday
Kirk Loan  	 Friday
Kirkhill Drive  	 Friday
Kirkhill Gardens  	 Friday
Kirkhill Road  	 Friday
Kirkhill Terrace  	 Friday
Kirklands  	 Wednesday
Kirklands Park Crescent  	 Thursday
Kirklands Park Gardens  	 Thursday
Kirklands Park Grove  	 Thursday
Kirklands Park Rigg  	 Thursday
Kirklands Park Street  	 Thursday
Kirkliston Road  	 Thursday
Kirkstyle Gardens  	 Thursday
Kisimul Court  	 Thursday
Klondyke Street  	 Friday
Knight Crescent  	 Friday
Ladehead  	 Tuesday
Ladiemeadow  	 Wednesday
Lady Nairne Crescent  	 Friday
Lady Nairne Grove  	 Friday
Lady Nairne Loan  	 Friday
Lady Nairne Place  	 Friday
Lady Road  	 Wednesday
Ladycroft  	 Wednesday
Ladysmith Road  	 Wednesday
Ladywell Avenue  	 Wednesday
Ladywell Gardens  	 Wednesday
Ladywell Road  	 Wednesday
Laichfield  	 Friday
Laichpark Loan  	 Friday
Laichpark Place  	 Friday
Laichpark Road  	 Friday
Lairdship Drive  	 Wednesday
Lamb'S Court  	 Tuesday
Lambsmiln Place  	 Thursday
Lammermoor Terrace  	 Friday
Lamont Place  	 Wednesday
Lampacre Road  	 Wednesday
Lanark Road  	 Wednesday
Lanark Road West  	 Wednesday
Lang Rigg  	 Thursday
Langton Road  	 Wednesday
Langwill Place  	 Wednesday
Lansdowne Crescent  	 Tuesday
Lapicide Place  	 Tuesday
Larbourfield  	 Wednesday
Larchfield  	 Wednesday
Larchfield Neuk  	 Wednesday
Larchgrove  	 Wednesday
Larchwood Square  	 Friday
Larkfield Gardens  	 Tuesday
Lasswade Road  	 Thursday
Latch Park  	 Wednesday
Latta Place  	 Tuesday
Lauder Loan  	 Wednesday
Lauder Road  	 Wednesday
Laurel Terrace  	 Tuesday
Lauriston Farm Road  	 Tuesday
Lauriston Gardens  	 Tuesday
Lauriston Place  	 Tuesday
Lauriston Street  	 Tuesday
Lauriston Terrace  	 Tuesday
Lauson Place  	 Thursday
Laverockbank Avenue  	 Tuesday
Laverockbank Crescent  	 Tuesday
Laverockbank Gardens  	 Tuesday
Laverockbank Grove  	 Tuesday
Laverockbank Road  	 Tuesday
Laverockbank Terrace  	 Tuesday
Laverockdale Crescent  	 Wednesday
Laverockdale Loan  	 Wednesday
Laverockdale Park  	 Wednesday
Law Place  	 Friday
Lawnmarket  	 Wednesday
Lawson Crescent  	 Thursday
Leamington Lane  	 Tuesday
Leamington Place  	 Tuesday
Leamington Terrace  	 Tuesday
Learmonth Avenue  	 Friday
Learmonth Crescent  	 Friday
Learmonth Gardens  	 Friday
Learmonth Gardens Mews  	 Friday
Learmonth Grove  	 Friday
Learmonth Park  	 Friday
Learmonth Place  	 Friday
Learmonth Terrace  	 Friday
Lee Crescent  	 Friday
Leith Walk  	 Tuesday
Lennel Avenue  	 Friday
Lennie Cottages  	 Thursday
Lennox Row  	 Tuesday
Lennox Street  	 Friday
Lennox Street Lane  	 Friday
Lennymuir  	 Thursday
Lerbar Way  	 Wednesday
Leslie Place  	 Friday
Leven Street  	 Tuesday
Lewis Terrace  	 Tuesday
Liberton Brae  	 Thursday
Liberton Dams  	 Thursday
Liberton Place  	 Thursday
Liberton Tower Lane  	 Thursday
Lidgate Shot  	 Thursday
Lily Terrace  	 Tuesday
Lilyhill Terrace  	 Friday
Lime Kilns View  	 Thursday
Limefield  	 Thursday
Lindean Place  	 Tuesday
Linden Avenue  	 Thursday
Lingerwood Lane  	 Friday
Linn Mill  	 Thursday
Lismore Avenue  	 Friday
Lismore Crescent  	 Friday
Liston Drive  	 Thursday
Liston Place  	 Thursday
Liston Road  	 Thursday
Little France Mills  	 Thursday
Little Street  	 Thursday
Littlejohn Avenue  	 Wednesday
Littlejohn Road  	 Wednesday
Littlejohn Wynd  	 Wednesday
Livingstone Place  	 Wednesday
Lixmount Avenue  	 Tuesday
Lixmount Gardens  	 Tuesday
Loaning Crescent  	 Tuesday
Loaning Road  	 Tuesday
Loch Place  	 Thursday
Loch Road  	 Thursday
Lochend Avenue  	 Tuesday
Lochend Castle Barns  	 Tuesday
Lochend Crescent  	 Tuesday
Lochend Drive  	 Tuesday
Lochend Gardens  	 Tuesday
Lochend Grove  	 Tuesday
Lochend Grove  	 Thursday
Lochend Park  	 Tuesday
Lochend Quadrant  	 Tuesday
Lochend Road South  	 Tuesday
Lochend Square  	 Tuesday
Lochiel Avenue  	 Thursday
Lochiel Crossway  	 Thursday
Lochiel Gardens  	 Thursday
Lochrin Buildings  	 Tuesday
Lockharton Avenue  	 Wednesday
Lockharton Crescent  	 Wednesday
Lockharton Gardens  	 Wednesday
Logan Street  	 Tuesday
Loganlea Avenue  	 Tuesday
Loganlea Drive  	 Tuesday
Loganlea Gardens  	 Tuesday
Loganlea Loan  	 Tuesday
Loganlea Place  	 Tuesday
Loganlea Road  	 Tuesday
Loganlea Terrace  	 Tuesday
Logie Green Gardens  	 Tuesday
Logie Green Loan  	 Tuesday
Logie Green Road  	 Tuesday
Lomond Road  	 Tuesday
London Street  	 Tuesday
Long Craig Road  	 Thursday
Long Crook  	 Thursday
Longformacus Road  	 Thursday
Longformarcus Road  	 Thursday
Longstone Avenue  	 Wednesday
Longstone Cottages  	 Wednesday
Longstone Crescent  	 Wednesday
Longstone Gardens  	 Wednesday
Longstone Grove  	 Wednesday
Longstone Road  	 Wednesday
Longstone Street  	 Wednesday
Longstone Terrace  	 Wednesday
Longstone View  	 Wednesday
Longwall Crescent  	 Friday
Lorne Street  	 Tuesday
Lothian Road  	 Tuesday
Lothian Road  	 Thursday
Lovedale Avenue  	 Wednesday
Lovedale Crescent  	 Wednesday
Lovedale Gardens  	 Wednesday
Lovedale Grove  	 Wednesday
Lovedale Road  	 Wednesday
Lovers' Lane  	 Thursday
Lower Granton Road  	 Tuesday
Lower Joppa  	 Friday
Lower London Road  	 Tuesday
Lowood  	 Thursday
Lowrie Gait  	 Thursday
Lucas Gardens  	 Wednesday
Lufra Bank  	 Tuesday
Lugton Circle  	 Thursday
Lugton Terrace  	 Thursday
Lumsden Court  	 Thursday
Lumsden Loan  	 Wednesday
Lumsden Wynd  	 Thursday
Lurie Place  	 Friday
Lussielaw Road  	 Wednesday
Lutton Place  	 Wednesday
Lyall Bow  	 Thursday
Lygon Road  	 Wednesday
Lymphoy  	 Wednesday
Lynedoch Place  	 Friday
Lynedoch Place Lane  	 Friday
MacDermott Avenue  	 Thursday
MacDermott Way  	 Thursday
Macdowall Road  	 Wednesday
Macfie Loan  	 Wednesday
Macgill Drive  	 Tuesday
Mackenzie Place  	 Friday
Mackinnon Crescent  	 Thursday
Macmath Gait  	 Thursday
Macmillan Crescent  	 Tuesday
Macmillan Terrace  	 Tuesday
MacMillian Terrace  	 Tuesday
Madeira Place  	 Tuesday
Magdala Crescent  	 Friday
Magdala Mews  	 Friday
Magdalene Avenue  	 Friday
Magdalene Court  	 Friday
Magdalene Drive  	 Friday
Magdalene Gardens  	 Friday
Magdalene Loan  	 Friday
Magdalene Medway  	 Friday
Magdalene Place  	 Friday
Maidencraig Crescent  	 Friday
Maidencraig Grove  	 Friday
Maingait Medway  	 Friday
Mains Of Craigmillar  	 Friday
Maitland Hog Lane  	 Thursday
Maitland Road  	 Thursday
Malachi Close  	 Thursday
Malachi Gait  	 Thursday
Malachi Green  	 Thursday
Malachi Rigg  	 Thursday
Malbet Park  	 Thursday
Malbet Wynd  	 Thursday
Malleny  	 Wednesday
Malleny Avenue  	 Wednesday
Malleny Millgate  	 Wednesday
Malta Terrace  	 Tuesday
Maltman Street  	 Friday
Manor Place  	 Friday
Manse Street  	 Wednesday
Mansfield Place  	 Tuesday
Mansfield Road  	 Wednesday
Mansionhouse Road  	 Wednesday
Maplewood Park  	 Friday
March Gait  	 Tuesday
March Grove  	 Tuesday
March Pines  	 Tuesday
March Road  	 Tuesday
Marchbank Drive  	 Wednesday
Marchbank Gardens  	 Wednesday
Marchbank Grove  	 Wednesday
Marchbank Place  	 Wednesday
Marchbank Way  	 Wednesday
Marchfield Grove  	 Tuesday
Marchfield Park  	 Tuesday
Marchfield Park Lane  	 Tuesday
Marchfield Terrace  	 Tuesday
Marchhall Crescent  	 Friday
Marchhall Place  	 Friday
Marchhall Road  	 Friday
Mardale Crescent  	 Wednesday
Marden Place  	 Thursday
Margaret Rose Avenue  	 Thursday
Margaret Rose Crescent  	 Thursday
Margaret Rose Drive  	 Thursday
Margaret Rose Loan  	 Thursday
Margaret Rose Walk  	 Thursday
Margaret Rose Way  	 Thursday
Marine Drive  	 Tuesday
Marionville Avenue  	 Tuesday
Marionville Crescent  	 Tuesday
Marionville Drive  	 Tuesday
Marionville Grove  	 Tuesday
Marionville Medway  	 Tuesday
Marionville Park  	 Tuesday
Marionville Road  	 Tuesday
Marlborough Street  	 Friday
Marlborough Street  	 Thursday
Marmion Crescent  	 Friday
Marrow Street  	 Tuesday
Marshall Road  	 Thursday
Martin Street  	 Thursday
Masson Close  	 Thursday
Maude Close  	 Thursday
Maude Park  	 Thursday
Maude Place  	 Thursday
Maurice Place  	 Wednesday
Mauseley Park  	 Thursday
Maxwell Street  	 Wednesday
Mayall Road  	 Tuesday
Maybank Villas  	 Friday
Maybury Drive  	 Thursday
Maybury Road  	 Thursday
Mayfield Gardens  	 Wednesday
Mayfield Road  	 Wednesday
Mayfield Terrace  	 Friday
Mayville Gardens  	 Tuesday
Mayville Gardens East  	 Tuesday
Mcarthur Rigg  	 Thursday
Mccartney Road  	 Friday
Mcdonald Place  	 Tuesday
Mcdonald Road  	 Tuesday
Mcdonald Street  	 Tuesday
Mclaren Road  	 Wednesday
Mclaren Terrace  	 Tuesday
Meadow Lane  	 Wednesday
Meadow Place Road  	 Wednesday
Meadowfield Avenue  	 Friday
Meadowfield Court  	 Friday
Meadowfield Drive  	 Friday
Meadowfield Gardens  	 Friday
Meadowfield Terrace  	 Friday
Meadowhouse Road  	 Wednesday
Meadowspot  	 Wednesday
Meadowsweet Drive  	 Thursday
Mearenside  	 Thursday
Meggetland Terrace  	 Wednesday
Melgund Terrace  	 Tuesday
Melville Street  	 Friday
Melville Terrace  	 Wednesday
Mentone Avenue  	 Thursday
Mentone Avenue  	 Friday
Mentone Gardens  	 Wednesday
Mentone Terrace  	 Wednesday
Merchiston Avenue  	 Wednesday
Merchiston Bank Avenue  	 Wednesday
Merchiston Bank Gardens  	 Wednesday
Merchiston Crescent  	 Wednesday
Merchiston Gardens  	 Wednesday
Merchiston Mews  	 Tuesday
Merchiston Park  	 Tuesday
Merchiston Place  	 Tuesday
Michaelmas Grove  	 Wednesday
Mid Gillsland Road  	 Wednesday
Mid Gogarloch Syke  	 Wednesday
Mid Liberton  	 Thursday
Mid Steil  	 Wednesday
Mid Terrace  	 Thursday
Middle Norton  	 Thursday
Middleby Street  	 Friday
Middleknowe  	 Wednesday
Middlepark  	 Wednesday
Middleshot  	 Wednesday
Middleton Avenue  	 Friday
Midmar Avenue  	 Wednesday
Midmar Drive  	 Wednesday
Midmar Gardens  	 Wednesday
Millar Crescent  	 Wednesday
Millar Place  	 Wednesday
Millar Place Lane  	 Wednesday
Millbank  	 Wednesday
Millerfield Place  	 Wednesday
Milligan Drive  	 Friday
Milligan Road  	 Friday
Milligan Street  	 Friday
Milnacre  	 Tuesday
Milton Crescent  	 Friday
Milton Drive  	 Friday
Milton Farm Road  	 Thursday
Milton Gardens North  	 Friday
Milton Gardens South  	 Friday
Milton Grove  	 Friday
Milton Road  	 Friday
Milton Road East  	 Friday
Milton Road West  	 Friday
Milton Terrace  	 Friday
Minto Street  	 Friday
Mitchell Street  	 Tuesday
Moat Drive  	 Friday
Moat Place  	 Friday
Moat Street  	 Friday
Moat Terrace  	 Friday
Moffat Way  	 Friday
Moira Park  	 Tuesday
Moira Terrace  	 Tuesday
Moira Terrace Lane  	 Tuesday
Moncrieff Terrace  	 Wednesday
Montagu Terrace  	 Tuesday
Montgomery Street  	 Tuesday
Moodie Place  	 Wednesday
Moodie Walk  	 Wednesday
Moray Park Terrace  	 Tuesday
Moray Place  	 Tuesday
Moredun Dell  	 Thursday
Moredun Park Loan  	 Thursday
Moredunvale Road  	 Thursday
Morham Gait  	 Wednesday
Morham Gardens  	 Wednesday
Morham Lea  	 Wednesday
Morham Park  	 Wednesday
Morison Gardens  	 Thursday
Morningside Court  	 Wednesday
Morningside Drive  	 Wednesday
Morningside Gardens  	 Wednesday
Morningside Grove  	 Wednesday
Morningside Park  	 Wednesday
Morningside Place  	 Wednesday
Morningside Road  	 Wednesday
Morningside Terrace  	 Wednesday
Morrison Crescent  	 Tuesday
Morton Street  	 Friday
Mortonhall Park Bank  	 Thursday
Mortonhall Park Crescent  	 Thursday
Mortonhall Park Drive  	 Thursday
Mortonhall Park Gardens  	 Thursday
Mortonhall Park Green  	 Thursday
Mortonhall Park Grove  	 Thursday
Mortonhall Park Loan  	 Thursday
Mortonhall Park Terrace  	 Thursday
Mortonhall Park View  	 Thursday
Mortonhall Park Way  	 Thursday
Mortonhall Road  	 Wednesday
Morven Street  	 Friday
Morvenside  	 Wednesday
Morvenside Close  	 Wednesday
Moston Terrace  	 Wednesday
Mottram Road  	 Tuesday
Moubray Grove  	 Thursday
Mount Alvernia  	 Thursday
Mount Lodge Place  	 Friday
Mount Vernon Road  	 Thursday
Mountcastle Bank  	 Friday
Mountcastle Crescent  	 Friday
Mountcastle Drive North  	 Friday
Mountcastle Drive South  	 Friday
Mountcastle Gardens  	 Friday
Mountcastle Green  	 Friday
Mountcastle Grove  	 Friday
Mountcastle Loan  	 Friday
Mountcastle Park  	 Friday
Mountcastle Place  	 Friday
Mountcastle Terrace  	 Friday
Mounthooly Loan  	 Thursday
Muir Wood Crescent  	 Wednesday
Muir Wood Drive  	 Wednesday
Muir Wood Grove  	 Wednesday
Muir Wood Place  	 Wednesday
Muir Wood Road  	 Wednesday
Muirdale Terrace  	 Tuesday
Muirehouse Drive  	 Tuesday
Muirend Avenue  	 Wednesday
Muirhouse Avenue  	 Tuesday
Muirhouse Avenue North  	 Tuesday
Muirhouse Bank  	 Tuesday
Muirhouse Close  	 Tuesday
Muirhouse Court  	 Tuesday
Muirhouse Crescent  	 Tuesday
Muirhouse Drive  	 Tuesday
Muirhouse Gardens  	 Tuesday
Muirhouse Green  	 Tuesday
Muirhouse Loan  	 Tuesday
Muirhouse Medway  	 Tuesday
Muirhouse Park  	 Tuesday
Muirhouse Parkway  	 Tuesday
Muirhouse Place East  	 Tuesday
Muirhouse Place West  	 Tuesday
Muirhouse Terrace  	 Tuesday
Muirhouse Way  	 Tuesday
Munro Drive  	 Wednesday
Murchie Crescent  	 Friday
Murray Cottages  	 Wednesday
Murrayburn Drive  	 Wednesday
Murrayburn Gardens  	 Wednesday
Murrayburn Green  	 Wednesday
Murrayburn Grove  	 Wednesday
Murrayburn Park  	 Wednesday
Murrayfield Avenue  	 Friday
Murrayfield Drive  	 Friday
Murrayfield Gardens  	 Friday
Murrayfield Place  	 Friday
Murrayfield Road  	 Friday
Myreside Court  	 Wednesday
Myreside Road  	 Wednesday
Myrtle Terrace  	 Tuesday
Nantwich Drive  	 Tuesday
Napier Loan  	 Wednesday
Napier Road  	 Wednesday
Nealands Road  	 Friday
Neidpath Court  	 Thursday
Nellfield  	 Thursday
Nelson Place  	 Tuesday
Nelson Street  	 Tuesday
Nether Craigour  	 Thursday
Nether Currie Crescent  	 Wednesday
Nether Currie Place  	 Wednesday
Nether Currie Road  	 Wednesday
Nether Lennie  	 Thursday
Nether Liberton Court  	 Thursday
Nether Liberton Lane  	 Thursday
Netherbank  	 Thursday
Netherbank View  	 Thursday
Netherby Road  	 Tuesday
New Broompark  	 Tuesday
New Broughton  	 Tuesday
New Lairdship Place  	 Friday
New Lane  	 Tuesday
New Mart Road  	 Friday
New Mart Square  	 Friday
New Orchardfield  	 Tuesday
New Swanston  	 Thursday
New Tower Place  	 Friday
Newbattle Terrace  	 Wednesday
Newbyth Road  	 Thursday
Newcraighall Drive  	 Friday
Newcraighall Road  	 Friday
Newhalls Road  	 Thursday
Newhaven Main Street  	 Tuesday
Newhaven Place  	 Tuesday
Newhaven Road  	 Tuesday
Newington Road  	 Friday
Newlands Park  	 Wednesday
Newliston Road  	 Thursday
Newmains Farm Lane  	 Thursday
Newmains Road  	 Thursday
Newmills Avenue  	 Wednesday
Newmills Crescent  	 Wednesday
Newmills Grove  	 Wednesday
Newmills Road  	 Wednesday
Newtoft Street  	 Thursday
Nichollfield  	 Tuesday
Nicolson Street  	 Wednesday
Nicolson Street  	 Thursday
Niddrie Cottages  	 Friday
Niddrie Farm Grove  	 Friday
Niddrie House Avenue  	 Friday
Niddrie House Drive  	 Friday
Niddrie House Gardens  	 Friday
Niddrie House Park  	 Friday
Niddrie House Square  	 Friday
Niddrie Mains Court  	 Friday
Niddrie Mains Drive  	 Friday
Niddrie Mains Road  	 Friday
Niddrie Mains Terrace  	 Friday
Niddrie Marischal Crescent  	 Friday
Niddrie Marischal Drive  	 Friday
Niddrie Marischal Gardens  	 Friday
Niddrie Marischal Green  	 Friday
Niddrie Marischal Grove  	 Friday
Niddrie Marischal Loan  	 Friday
Niddrie Marischal Place  	 Friday
Niddrie Marischal Road  	 Friday
Niddrie Marischal Street  	 Friday
Niddrie Mill Avenue  	 Friday
Niddrie Mill Crescent  	 Friday
Niddrie Mill Drive  	 Friday
Niddrie Mill Grove  	 Friday
Niddrie Mill Place  	 Friday
Niddrie Mill Terrace  	 Friday
Niddry Street  	 Wednesday
Nigel Loan  	 Thursday
Nile Grove  	 Wednesday
Nisbett Drive  	 Wednesday
Nisbett Walk  	 Thursday
Niven Way  	 Thursday
Noble Place  	 Tuesday
North Bughtlin Bank  	 Thursday
North Bughtlin Brae  	 Thursday
North Bughtlin Gate  	 Thursday
North Bughtlin Neuk  	 Thursday
North Bughtlin Place  	 Thursday
North Bughtlinfield  	 Thursday
North Bughtlinrig  	 Thursday
North Bughtlinside  	 Thursday
North Cairntow  	 Friday
North Castle Street  	 Tuesday
North East Circus Place  	 Tuesday
North Fort Street  	 Tuesday
North Greens  	 Friday
North Gyle Avenue  	 Thursday
North Gyle Drive  	 Thursday
North Gyle Farm Court  	 Thursday
North Gyle Farm Lane  	 Thursday
North Gyle Grove  	 Thursday
North Gyle Loan  	 Thursday
North Gyle Park  	 Thursday
North Gyle Road  	 Thursday
North Gyle Terrace  	 Thursday
North Hillhousefield  	 Tuesday
North Leith Sands  	 Tuesday
North Meggetland  	 Wednesday
North Park Terrace  	 Friday
North Peffer Place  	 Friday
North Platt Crescent  	 Thursday
North Platt Gardens  	 Thursday
North Street  	 Thursday
North Werber Park  	 Tuesday
North Werber Place  	 Tuesday
North West Circus Place  	 Tuesday
Northfield Avenue  	 Friday
Northfield Broadway  	 Friday
Northfield Circus  	 Friday
Northfield Crescent  	 Friday
Northfield Drive  	 Friday
Northfield Farm Avenue  	 Friday
Northfield Farm Road  	 Friday
Northfield Gardens  	 Friday
Northfield Grove  	 Friday
Northfield Park  	 Friday
Northfield Park Grove  	 Friday
Northfield Road  	 Friday
Northfield Square  	 Friday
Northfield Square  	 Thursday
Northfield Terrace  	 Friday
Northlawn Terrace  	 Tuesday
Northumberland Place  	 Tuesday
Northumberland Place Lane  	 Tuesday
Northumberland Street  	 Tuesday
Northumberland Street North East La  	 Tuesday
Northumberland Street North West La  	 Tuesday
Northumberland Street South East La  	 Tuesday
Northumberland Street South West La  	 Tuesday
Norton Mains  	 Thursday
Norton Park  	 Tuesday
Norton Park  	 Thursday
Norwal Drive  	 Thursday
Norwal Street  	 Thursday
O'Donnel Road  	 Wednesday
O'Donnel Street  	 Wednesday
Oak Lane  	 Friday
Oakfield Place  	 Wednesday
Oaklands Square  	 Friday
Oakville Terrace  	 Tuesday
Oakwood Court  	 Friday
Observatory Green  	 Wednesday
Observatory Road  	 Wednesday
Ochil Court  	 Thursday
Ochiltree Gardens  	 Friday
Ogilvie Terrace  	 Tuesday
Old Burdiehouse Road  	 Thursday
Old Church Lane  	 Friday
Old Farm Avenue  	 Wednesday
Old Farm Place  	 Wednesday
Old Kirk Road  	 Friday
Old Liston Road  	 Thursday
Old Mill Lane  	 Thursday
Old Newmills Road  	 Wednesday
Old Quarry Road  	 Thursday
Oliphant Lane  	 Tuesday
Oliver Close  	 Tuesday
Orchard Bank  	 Friday
Orchard Brae  	 Friday
Orchard Brae Avenue  	 Friday
Orchard Brae Gardens  	 Friday
Orchard Brae Gardens West  	 Friday
Orchard Brae West  	 Friday
Orchard Crescent  	 Friday
Orchard Drive  	 Friday
Orchard Grove  	 Friday
Orchard Place  	 Friday
Orchard Road  	 Friday
Orchard Road South  	 Friday
Orchard Terrace  	 Friday
Orchard Toll  	 Friday
Orchardfield Avenue  	 Wednesday
Orchardhead Loan  	 Thursday
Orchardhead Road  	 Thursday
Ormelie Terrace  	 Friday
Ormidale Terrace  	 Friday
Orrok Park  	 Thursday
Orwell Place  	 Tuesday
Orwell Terrace  	 Tuesday
Osborne Terrace  	 Friday
Ostler Loan  	 Friday
Oswald Court  	 Wednesday
Oswald Road  	 Wednesday
Oswald Terrace  	 Wednesday
Otterburn Park  	 Wednesday
Overton Farm Road  	 Thursday
Owen View  	 Wednesday
Oxford Terrace  	 Friday
Oxgangs Avenue  	 Wednesday
Oxgangs Bank  	 Thursday
Oxgangs Brae  	 Thursday
Oxgangs Crescent  	 Wednesday
Oxgangs Drive  	 Wednesday
Oxgangs Farm Avenue  	 Wednesday
Oxgangs Farm Drive  	 Wednesday
Oxgangs Farm Gardens  	 Wednesday
Oxgangs Farm Grove  	 Wednesday
Oxgangs Farm Loan  	 Wednesday
Oxgangs Farm Terrace  	 Wednesday
Oxgangs Gardens  	 Wednesday
Oxgangs Green  	 Thursday
Oxgangs Hill  	 Thursday
Oxgangs Loan  	 Thursday
Oxgangs Medway  	 Thursday
Oxgangs Park  	 Wednesday
Oxgangs Path  	 Thursday
Oxgangs Path East  	 Thursday
Oxgangs Place  	 Wednesday
Oxgangs Rise  	 Wednesday
Oxgangs Road  	 Thursday
Oxgangs Row  	 Wednesday
Oxgangs Street  	 Wednesday
Oxgangs Terrace  	 Wednesday
Oxgangs View  	 Thursday
Packard Street  	 Thursday
Packer Place  	 Friday
Packer Road  	 Friday
Paisley Avenue  	 Friday
Paisley Crescent  	 Friday
Paisley Drive  	 Friday
Paisley Gardens  	 Friday
Paisley Grove  	 Friday
Paisley Terrace  	 Friday
Palmer Place  	 Wednesday
Palmer Road  	 Wednesday
Palmerston Place  	 Friday
Palmerston Place Lane  	 Friday
Palmerston Road  	 Wednesday
Pape'S Cottages  	 Friday
Park Avenue  	 Friday
Park Crescent  	 Thursday
Park Gardens  	 Thursday
Park Grove  	 Thursday
Park Place  	 Tuesday
Park Road  	 Tuesday
Park Terrace  	 Friday
Park View  	 Friday
Parker Avenue  	 Tuesday
Parker Terrace  	 Tuesday
Parkgrove Avenue  	 Thursday
Parkgrove Bank  	 Thursday
Parkgrove Crescent  	 Thursday
Parkgrove Drive  	 Thursday
Parkgrove Gardens  	 Thursday
Parkgrove Green  	 Thursday
Parkgrove Loan  	 Thursday
Parkgrove Neuk  	 Thursday
Parkgrove Path  	 Thursday
Parkgrove Place  	 Thursday
Parkgrove Road  	 Thursday
Parkgrove Row  	 Thursday
Parkgrove Street  	 Thursday
Parkgrove Terrace  	 Thursday
Parkgrove View  	 Thursday
Parkhead Avenue  	 Wednesday
Parkhead Crescent  	 Wednesday
Parkhead Drive  	 Wednesday
Parkhead Gardens  	 Wednesday
Parkhead Grove  	 Wednesday
Parkhead Loan  	 Wednesday
Parkhead Place  	 Wednesday
Parkhead Street  	 Wednesday
Parkhead Terrace  	 Wednesday
Parkhead View  	 Wednesday
Parkside  	 Thursday
Parkside Terrace  	 Wednesday
Parkvale Place  	 Tuesday
Parliament Loan  	 Thursday
Parliament Way  	 Thursday
Parrotshot  	 Friday
Paterson Place  	 Friday
Path Brae  	 Thursday
Paties Road  	 Wednesday
Paton Place  	 Friday
Pavilion Crescent  	 Wednesday
Paxton Wynd  	 Friday
Peacocktail Close  	 Friday
Pearce Avenue  	 Friday
Pearce Grove  	 Friday
Pearce Road  	 Friday
Peatville Gardens  	 Wednesday
Peatville Terrace  	 Wednesday
Peebles Terrace  	 Tuesday
Peel Terrace  	 Wednesday
Peffer Place  	 Friday
Peffermill Road  	 Friday
Peggy'S Mill Road  	 Thursday
Pembroke Place  	 Friday
Peniel Road  	 Thursday
Pennywell Cottages  	 Tuesday
Pennywell Gardens  	 Tuesday
Pennywell Grove  	 Tuesday
Pennywell Medway  	 Tuesday
Pennywell Place  	 Tuesday
Pennywell Road  	 Tuesday
Pennywell Villas  	 Tuesday
Pentland Crescent  	 Thursday
Pentland Drive  	 Thursday
Pentland Gardens  	 Thursday
Pentland Grove  	 Thursday
Pentland Place  	 Wednesday
Pentland Road  	 Wednesday
Pentland View Road  	 Thursday
Pentland Villas  	 Wednesday
Peveril Terrace  	 Thursday
Philip Terrace  	 Thursday
Pier Place  	 Tuesday
Piersfield Grove  	 Tuesday
Piersfield Place  	 Tuesday
Piersfield Terrace  	 Tuesday
Piershill Place  	 Friday
Piershill Terrace  	 Friday
Pikes Pool Drive  	 Thursday
Pillans Square  	 Tuesday
Pilmuir Grove  	 Wednesday
Pilrig Cottages  	 Tuesday
Pilrig Gardens  	 Tuesday
Pilrig Heights  	 Tuesday
Pilrig House Close  	 Tuesday
Pilrig Place  	 Tuesday
Pilrig Street  	 Tuesday
Pilton Avenue  	 Tuesday
Pilton Crescent  	 Tuesday
Pilton Drive  	 Tuesday
Pilton Drive North  	 Tuesday
Pilton Gardens  	 Tuesday
Pilton Loan  	 Tuesday
Pilton Park  	 Tuesday
Pilton Place  	 Tuesday
Pincott Drive  	 Thursday
Pincott Lane  	 Thursday
Pinegrove Gardens  	 Thursday
Pinetum Lane  	 Thursday
Pinkhill  	 Friday
Pinkhill Park  	 Friday
Pipe Street  	 Friday
Pirniefield Bank  	 Tuesday
Pirniefield Gardens  	 Tuesday
Pirniefield Grove  	 Tuesday
Pirniefield Place  	 Tuesday
Pirniefield Terrace  	 Tuesday
Pitcairn Grove  	 Wednesday
Pitsligo Road  	 Wednesday
Pittville Street  	 Friday
Pittville Street Lane  	 Friday
Platt Hill Lane  	 Thursday
Plewlandcroft  	 Thursday
Plewlands Avenue  	 Wednesday
Plewlands Gardens  	 Wednesday
Plewlands Place  	 Thursday
Plewlands Terrace  	 Wednesday
Pleydell Place  	 Thursday
Pollard Glebe  	 Friday
Polwarth Gardens  	 Wednesday
Polwarth Grove  	 Wednesday
Polwarth Park  	 Wednesday
Polwarth Place  	 Wednesday
Polwarth Terrace  	 Wednesday
Ponton Street  	 Tuesday
Poplar Lane  	 Tuesday
Portland Street  	 Tuesday
Portmore Drive  	 Thursday
Portobello High Street  	 Friday
Powderhall Rigg  	 Tuesday
Powderhall Road  	 Tuesday
Prestonfield Avenue  	 Friday
Prestonfield Bank  	 Friday
Prestonfield Crescent  	 Friday
Prestonfield Gardens  	 Friday
Prestonfield Road  	 Friday
Prestonfield Terrace  	 Friday
Priestfield Avenue  	 Friday
Priestfield Crescent  	 Friday
Priestfield Gardens  	 Friday
Priestfield Grove  	 Friday
Priestfield Road  	 Friday
Priestfield Road North  	 Friday
Priesthill Place  	 Thursday
Priesthill Street  	 Thursday
Primrose Bank Road  	 Tuesday
Primrose Drive  	 Thursday
Primrose Gardens  	 Thursday
Primrose Terrace  	 Tuesday
Princes Street  	 Tuesday
Princess Mary Road  	 Friday
Pringle Drive  	 Friday
Pringle Street  	 Friday
Pringle Terrace  	 Friday
Printonan Crescent  	 Thursday
Priory Grove  	 Thursday
Promenade  	 Thursday
Promenade  	 Friday
Prospect Bank Crescent  	 Tuesday
Prospect Bank Gardens  	 Tuesday
Prospect Bank Grove  	 Tuesday
Prospect Bank Place  	 Tuesday
Prospect Bank Road  	 Tuesday
Prospect Bank Terrace  	 Tuesday
Provost Haugh  	 Wednesday
Provost Milne Grove  	 Thursday
Quality Street  	 Tuesday
Quality Street Lane  	 Tuesday
Quarry Cottages  	 Friday
Quarry Howe  	 Wednesday
Quarrybank  	 Wednesday
Quarrybank Close  	 Wednesday
Quarrybank Court  	 Wednesday
Quarrybank End  	 Wednesday
Quarrypark Drive  	 Thursday
Quarryview  	 Wednesday
Queen Charlotte Lane  	 Tuesday
Queen Charlotte Lane  	 Thursday
Queen Charlotte Street  	 Tuesday
Queen Margaret Close  	 Thursday
Queen Margaret Drive  	 Thursday
Queen Street  	 Tuesday
Queen'S Avenue  	 Tuesday
Queen'S Avenue South  	 Tuesday
Queen'S Bay Crescent  	 Friday
Queen'S Crescent  	 Wednesday
Queen'S Gardens  	 Tuesday
Queen'S Park Avenue  	 Friday
Queen'S Road  	 Tuesday
Queen'S Walk  	 Friday
Queensferry Road  	 Thursday
Queensferry Street Lane  	 Tuesday
Queensferry Terrace  	 Friday
Quilts Wynd  	 Tuesday
Quintinshill Place  	 Tuesday
Rackstraw Place  	 Friday
Rae'S Court  	 Thursday
Raeburn Street  	 Friday
Raeburn Street  	 Thursday
Raith Drive  	 Friday
Raith Gait  	 Friday
Raith Gardens  	 Friday
Raith Gate  	 Friday
Ramslack Street  	 Wednesday
Randolph Crescent  	 Tuesday
Randolph Lane  	 Tuesday
Randolph Place  	 Tuesday
Rankin Avenue  	 Wednesday
Rankin Drive  	 Wednesday
Rankin Road  	 Wednesday
Rannoch Grove  	 Friday
Rannoch Place  	 Friday
Rannoch Road  	 Friday
Rannoch Terrace  	 Friday
Ransfield Road  	 Thursday
Ransome Gardens  	 Friday
Ratcliffe Terrace  	 Wednesday
Rathbone Place  	 Friday
Ratho Mains  	 Thursday
Ratho Park Road  	 Thursday
Rattray Crescent  	 Wednesday
Rattray Drive  	 Wednesday
Rattray Grove  	 Wednesday
Rattray Loan  	 Wednesday
Rattray Way  	 Wednesday
Ravelrig Drive  	 Wednesday
Ravelrig Gait  	 Wednesday
Ravelrig Hill  	 Wednesday
Ravelrig Park  	 Wednesday
Ravelrig Road  	 Wednesday
Ravelrig Wynd  	 Wednesday
Ravelston Dykes  	 Friday
Ravelston Dykes Lane  	 Friday
Ravelston Dykes Road  	 Friday
Ravelston House Grove  	 Friday
Ravelston House Loan  	 Friday
Ravelston House Park  	 Friday
Ravelston House Road  	 Friday
Ravelston Park  	 Friday
Ravelston Place  	 Friday
Ravelston Rise  	 Friday
Ravelston Terrace  	 Friday
Ravenscroft Gardens  	 Thursday
Ravenscroft Place  	 Thursday
Ravenscroft Street  	 Thursday
Ravenswood Avenue  	 Friday
Redbraes Grove  	 Tuesday
Redbraes Place  	 Tuesday
Redford Avenue  	 Wednesday
Redford Bank  	 Wednesday
Redford Crescent  	 Wednesday
Redford Drive  	 Wednesday
Redford Gardens  	 Wednesday
Redford Grove  	 Wednesday
Redford Loan  	 Wednesday
Redford Neuk  	 Wednesday
Redford Place  	 Wednesday
Redford Terrace  	 Wednesday
Redford Walk  	 Wednesday
Redgauntlet Terrace  	 Friday
Redhall Avenue  	 Wednesday
Redhall Bank Road  	 Wednesday
Redhall Crescent  	 Wednesday
Redhall Drive  	 Wednesday
Redhall Gardens  	 Wednesday
Redhall Grove  	 Wednesday
Redhall House Avenue  	 Wednesday
Redhall House Close  	 Wednesday
Redhall House Drive  	 Wednesday
Redhall Place  	 Wednesday
Redhall Road  	 Wednesday
Redhall View  	 Wednesday
Redsman Drive  	 Friday
Redsman Place  	 Friday
Redsman Street  	 Friday
Redwing Wynd  	 Thursday
Regent Road  	 Tuesday
Regent Street  	 Friday
Regent Street Lane  	 Thursday
Regent Street Lane  	 Friday
Regent Terrace  	 Tuesday
Regent Terrace Mews  	 Tuesday
Regis Court  	 Thursday
Reid Terrace  	 Tuesday
Reid'S Court  	 Wednesday
Relugas Gardens  	 Wednesday
Relugas Place  	 Wednesday
Relugas Road  	 Wednesday
Restalrig Avenue  	 Tuesday
Restalrig Circus  	 Tuesday
Restalrig Crescent  	 Tuesday
Restalrig Drive  	 Tuesday
Restalrig Gardens  	 Tuesday
Restalrig Road  	 Tuesday
Restalrig Square  	 Tuesday
Restalrig Terrace  	 Tuesday
Reynolds Road  	 Tuesday
Riccarton Avenue  	 Wednesday
Riccarton Crescent  	 Wednesday
Riccarton Drive  	 Wednesday
Riccarton Grove  	 Wednesday
Riccarton Mains Road  	 Wednesday
Richmond Terrace  	 Tuesday
Riding Park  	 Thursday
Rintoul Place  	 Tuesday
Riselaw Crescent  	 Thursday
Riselaw Place  	 Thursday
Riselaw Road  	 Thursday
Riselaw Terrace  	 Thursday
Riversdale Crescent  	 Friday
Riversdale Grove  	 Friday
Riversdale Road  	 Friday
Riverside Road  	 Thursday
Robb'S Loan  	 Friday
Robb'S Loan Grove  	 Friday
Robert Burns Drive  	 Thursday
Robin Place  	 Friday
Rocheid Park  	 Tuesday
Rochester Terrace  	 Wednesday
Roddinglaw Road  	 Wednesday
Rona Avenue  	 Thursday
Rose Lane  	 Thursday
Rose Park  	 Tuesday
Rosebank Cottages  	 Tuesday
Rosebank Gardens  	 Tuesday
Rosebank Grove  	 Tuesday
Rosebank Road  	 Tuesday
Rosebery Avenue  	 Thursday
Rosebery Court  	 Thursday
Rosebery Crescent  	 Friday
Rosebery Crescent Lane  	 Friday
Roseburn Avenue  	 Friday
Roseburn Cliff  	 Friday
Roseburn Crescent  	 Friday
Roseburn Drive  	 Friday
Roseburn Gardens  	 Friday
Roseburn Maltings  	 Friday
Roseburn Place  	 Friday
Roseburn Street  	 Friday
Rosefield Avenue  	 Thursday
Rosefield Avenue  	 Friday
Rosefield Avenue Lane  	 Friday
Rosefield Place  	 Friday
Rosefield Street  	 Friday
Rosevale Place  	 Tuesday
Roseville Gardens  	 Tuesday
Ross Gardens  	 Wednesday
Ross Place  	 Wednesday
Ross Road  	 Wednesday
Rosshill Terrace  	 Thursday
Rosslyn Crescent  	 Tuesday
Rosslyn Terrace  	 Tuesday
Rothesay Mews  	 Friday
Rothesay Place  	 Friday
Rothesay Terrace  	 Friday
Roull Grove  	 Wednesday
Roull Place  	 Wednesday
Roull Road  	 Wednesday
Rowallan Court  	 Thursday
Rowantree Avenue  	 Wednesday
Rowantree Grove  	 Wednesday
Rowieston Drive  	 Thursday
Royal Circus  	 Tuesday
Royal Crescent  	 Tuesday
Royal Terrace  	 Tuesday
Royal Terrace Mews  	 Tuesday
Royston Mains Avenue  	 Tuesday
Royston Mains Crescent  	 Tuesday
Royston Mains Gardens  	 Tuesday
Royston Mains Green  	 Tuesday
Royston Mains Place  	 Tuesday
Royston Mains Road  	 Tuesday
Royston Mains Street  	 Tuesday
Russell Place  	 Tuesday
Russell Road  	 Friday
Rustic Cottages  	 Wednesday
Rutherford Drive  	 Thursday
Ruthven Place  	 Friday
Ryehill Avenue  	 Tuesday
Ryehill Gardens  	 Tuesday
Ryehill Grove  	 Tuesday
Ryehill Place  	 Tuesday
Ryehill Terrace  	 Tuesday
Saddle Tree Loan  	 Friday
Salisbury Place  	 Friday
Salisbury Road  	 Friday
Salvesen Crescent  	 Tuesday
Salvesen Gardens  	 Tuesday
Salvesen Grove  	 Tuesday
Salvesen Terrace  	 Tuesday
Sandercombe Drive  	 Thursday
Sandford Gardens  	 Friday
Sandilands Road  	 Friday
Sandilands View  	 Friday
Sandstone Crescent  	 Friday
Sassoon Grove  	 Wednesday
Saughton Avenue  	 Friday
Saughton Crescent  	 Friday
Saughton Gardens  	 Friday
Saughton Grove  	 Friday
Saughton Loan  	 Friday
Saughton Mains Avenue  	 Friday
Saughton Mains Bank  	 Friday
Saughton Mains Drive  	 Friday
Saughton Mains Gardens  	 Friday
Saughton Mains Grove  	 Friday
Saughton Mains Loan  	 Friday
Saughton Mains Park  	 Friday
Saughton Mains Place  	 Friday
Saughton Mains Street  	 Friday
Saughton Mains Terrace  	 Friday
Saughton Park  	 Friday
Saughton Road  	 Friday
Saughton Road North  	 Wednesday
Saughtonhall Avenue  	 Friday
Saughtonhall Avenue West  	 Friday
Saughtonhall Circus  	 Friday
Saughtonhall Crescent  	 Friday
Saughtonhall Drive  	 Friday
Saughtonhall Gardens  	 Friday
Saughtonhall Grove  	 Friday
Saughtonhall Place  	 Friday
Saughtonhall Terrace  	 Friday
Savile Place  	 Wednesday
Savile Terrace  	 Wednesday
Saxe-Coburg Place  	 Tuesday
Saxe-Coburg Street  	 Tuesday
Saxe-Coburg Terrace  	 Tuesday
Scald Law Drive  	 Wednesday
Scanlan Street  	 Friday
School Brae  	 Thursday
Sciennes  	 Wednesday
Sciennes Gardens  	 Wednesday
Sciennes Hill Place  	 Wednesday
Sciennes Road  	 Wednesday
Scone Gardens  	 Friday
Scotland Street  	 Tuesday
Scotstoun Avenue  	 Thursday
Scotstoun Green  	 Thursday
Scotstoun Park  	 Thursday
Scott Street  	 Friday
Seacot  	 Tuesday
Seafield Avenue  	 Tuesday
Seafield Place  	 Tuesday
Seafield Road  	 Tuesday
Seafield Road East  	 Tuesday
Seafield Street  	 Tuesday
Seaforth Drive  	 Tuesday
Seaview Crescent  	 Friday
Seaview Terrace  	 Friday
Sentry Knowe Place  	 Thursday
Sentry Knowe Row  	 Thursday
Seton Place  	 Wednesday
Shale Road  	 Thursday
Shandon Crescent  	 Tuesday
Shandon Place  	 Tuesday
Shandon Road  	 Tuesday
Shandon Street  	 Tuesday
Shandon Terrace  	 Tuesday
Shanter Way  	 Thursday
Sharp Street  	 Tuesday
Shavelin Drive  	 Friday
Shaw'S Square  	 Tuesday
Shearie Knowe Gardens  	 Wednesday
Sheriff Bank  	 Tuesday
Shiels Way  	 Wednesday
Shore  	 Tuesday
Shore Place  	 Tuesday
Shore Place  	 Thursday
Shore Road  	 Thursday
Sidings Way  	 Friday
Sighthill Avenue  	 Wednesday
Sighthill Court  	 Wednesday
Sighthill Crescent  	 Wednesday
Sighthill Drive  	 Wednesday
Sighthill Gardens  	 Wednesday
Sighthill Grove  	 Wednesday
Sighthill Loan  	 Wednesday
Sighthill Neuk  	 Wednesday
Sighthill Park  	 Wednesday
Sighthill Place  	 Wednesday
Sighthill Rise  	 Wednesday
Sighthill Road  	 Wednesday
Sighthill Street  	 Wednesday
Sighthill Terrace  	 Wednesday
Sighthill View  	 Wednesday
Silverknowes Avenue  	 Tuesday
Silverknowes Bank  	 Tuesday
Silverknowes Brae  	 Tuesday
Silverknowes Court  	 Tuesday
Silverknowes Crescent  	 Tuesday
Silverknowes Dell  	 Tuesday
Silverknowes Drive  	 Tuesday
Silverknowes Eastway  	 Tuesday
Silverknowes Gardens  	 Tuesday
Silverknowes Green  	 Tuesday
Silverknowes Grove  	 Tuesday
Silverknowes Hill  	 Tuesday
Silverknowes Loan  	 Tuesday
Silverknowes Midway  	 Tuesday
Silverknowes Neuk  	 Tuesday
Silverknowes Parkway  	 Tuesday
Silverknowes Place  	 Tuesday
Silverknowes Road  	 Tuesday
Silverknowes Road East  	 Tuesday
Silverknowes Road South  	 Tuesday
Silverknowes Southway  	 Tuesday
Silverknowes Terrace  	 Tuesday
Silverknowes View  	 Tuesday
Simon Square  	 Wednesday
Sinclair Place  	 Tuesday
Sinclair Place  	 Thursday
Sir Harry Lauder Road  	 Friday
Skerryvore Loan  	 Thursday
Slaeside  	 Wednesday
Slateford Gait  	 Tuesday
Slateford Gait  	 Thursday
Sleigh Drive  	 Tuesday
Sleigh Gardens  	 Tuesday
Smeaton Gardens  	 Friday
Smiddy Wynd  	 Thursday
Smith'S Land  	 Thursday
Society Road  	 Thursday
Somerset Place  	 Tuesday
Somerville Road  	 Wednesday
Sommerville Gardens  	 Thursday
South Barnton Avenue  	 Tuesday
South Beechwood  	 Friday
South Carron Crescent  	 Tuesday
South Carron Wynd  	 Tuesday
South Clerk Street  	 Wednesday
South East Circus Place  	 Tuesday
South Elixa Place  	 Friday
South Ettrick Road  	 Wednesday
South Fort Street  	 Tuesday
South Gayfield Lane  	 Tuesday
South Gillsland Road  	 Wednesday
South Gray Street  	 Friday
South Gray'S Close  	 Wednesday
South Groathill Avenue  	 Friday
South Gyle Loan  	 Wednesday
South Gyle Mains  	 Wednesday
South Gyle Park  	 Wednesday
South Gyle Road  	 Wednesday
South Gyle Wynd  	 Wednesday
South Lauder Road  	 Wednesday
South Laverockbank Avenue  	 Tuesday
South Learmonth Avenue  	 Friday
South Learmonth Gardens  	 Friday
South Lorne Place  	 Tuesday
South Maybury  	 Thursday
South Mellis Park  	 Friday
South Morton Street  	 Friday
South Oswald Road  	 Wednesday
South Park  	 Tuesday
South Parrotshot  	 Friday
South Scotstoun  	 Thursday
South Steil  	 Wednesday
South Trinity Road  	 Tuesday
Southfield Bank  	 Friday
Southfield Farm Grove  	 Friday
Southfield Gardens East  	 Friday
Southfield Gardens West  	 Friday
Southfield Loan  	 Friday
Southfield Road East  	 Friday
Southfield Road West  	 Friday
Southfield Square  	 Friday
Southfield Terrace  	 Friday
Southfield Villas  	 Friday
Southhouse Avenue  	 Thursday
Southhouse Brae  	 Thursday
Southhouse Broadway  	 Thursday
Southhouse Close  	 Thursday
Southhouse Crescent  	 Thursday
Southhouse Crossway  	 Thursday
Southhouse Drive  	 Thursday
Southhouse Gardens  	 Thursday
Southhouse Grove  	 Thursday
Southhouse Loan  	 Thursday
Southhouse Place  	 Thursday
Southhouse Road  	 Thursday
Southhouse Terrace  	 Thursday
Southhouse Walk  	 Thursday
Soutra Road  	 Thursday
Spa Place  	 Friday
Spence Street  	 Friday
Spencer Place  	 Tuesday
Spinner Lane  	 Thursday
Spring Gardens  	 Friday
Springfield  	 Tuesday
Springfield Crescent  	 Thursday
Springfield Lea  	 Thursday
Springfield Place  	 Thursday
Springfield Road  	 Thursday
Springfield Street  	 Tuesday
Springfield Terrace  	 Thursday
Springfield View  	 Thursday
Springwell Terrace  	 Thursday
Springwood Park  	 Thursday
Spruce Way  	 Wednesday
Spylaw Avenue  	 Wednesday
Spylaw Bank Road  	 Wednesday
Spylaw Park  	 Wednesday
Spylaw Road  	 Wednesday
Spylaw Street  	 Wednesday
St Aidens Place  	 Friday
St Aidens Road  	 Friday
St Alban'S Road  	 Wednesday
St Andrew Place  	 Tuesday
St Andrew Place  	 Thursday
St Bernard'S Crescent  	 Friday
St Bernard'S Row  	 Tuesday
St Catherine'S Gardens  	 Friday
St Catherine'S Place  	 Wednesday
St Clair Avenue  	 Tuesday
St Clair Place  	 Tuesday
St Clair Road  	 Tuesday
St Clair Street  	 Tuesday
St Clair Terrace  	 Wednesday
St Colme Street  	 Tuesday
St Cuthbert'S Court  	 Wednesday
St Fillan'S Terrace  	 Wednesday
St Francis Way  	 Friday
St John Street  	 Wednesday
St John'S Avenue  	 Friday
St John'S Crescent  	 Friday
St John'S Terrace  	 Friday
St Katharine'S Brae  	 Thursday
St Katharine'S Crescent  	 Thursday
St Katharine'S Loan  	 Thursday
St Leonard'S Bank  	 Wednesday
St Leonard'S Hill  	 Wednesday
St Leonard'S Street  	 Wednesday
St Margaret'S Road  	 Wednesday
St Mark'S Lane  	 Friday
St Mark'S Place  	 Friday
St Mary'S Place  	 Friday
St Ninian'S Drive  	 Friday
St Ninian'S Road  	 Friday
St Ninian'S Terrace  	 Wednesday
St Peter'S Buildings  	 Tuesday
St Peter'S Place  	 Tuesday
St Ronan'S Terrace  	 Wednesday
St Teresa Place  	 Wednesday
St Thomas Road  	 Wednesday
St Vincent Street  	 Tuesday
Stable Lane  	 Wednesday
Stafford Street  	 Tuesday
Stair Park  	 Friday
Stair Place  	 Thursday
Standingstane Road  	 Thursday
Stanedykehead  	 Thursday
Stanhope Place  	 Friday
Stanhope Street  	 Friday
Stanley Place  	 Tuesday
Stanley Road  	 Tuesday
Stanley Street  	 Friday
Stanwell Street  	 Tuesday
Stapeley Avenue  	 Tuesday
Starbank Road  	 Tuesday
Stark'S Cottages  	 Wednesday
Station Loan  	 Wednesday
Station Terrace  	 Thursday
Station View  	 Thursday
Stein Street  	 Thursday
Stenhouse Avenue  	 Friday
Stenhouse Avenue West  	 Friday
Stenhouse Cottages  	 Friday
Stenhouse Crescent  	 Friday
Stenhouse Drive  	 Friday
Stenhouse Gardens  	 Friday
Stenhouse Gardens North  	 Friday
Stenhouse Grove  	 Friday
Stenhouse Mill Crescent  	 Friday
Stenhouse Mill Lane  	 Friday
Stenhouse Place East  	 Friday
Stenhouse Place West  	 Friday
Stenhouse Road  	 Friday
Stenhouse Street East  	 Friday
Stenhouse Street West  	 Friday
Stenhouse Terrace  	 Friday
Stennis Gardens  	 Thursday
Stevedore Place  	 Tuesday
Stevenson Avenue  	 Friday
Stevenson Drive  	 Friday
Stevenson Grove  	 Friday
Stevenson Road  	 Friday
Stevenson Terrace  	 Friday
Stewart Avenue  	 Wednesday
Stewart Clark Avenue  	 Thursday
Stewart Crescent  	 Wednesday
Stewart Gardens  	 Wednesday
Stewart Place  	 Thursday
Stewart Place  	 Wednesday
Stewart Road  	 Wednesday
Stewart Terrace  	 Thursday
Stillhouse Loan  	 Thursday
Stirling Road  	 Thursday
Stirling Road  	 Tuesday
Stoneycroft Road  	 Thursday
Stoneyflatts  	 Thursday
Stoneyflatts Crescent  	 Thursday
Stoneyflatts Park  	 Thursday
Strachan Gardens  	 Friday
Strachan Road  	 Tuesday
Straiton Place  	 Friday
Strathalmond Court  	 Thursday
Strathalmond Green  	 Thursday
Strathalmond Park  	 Thursday
Strathalmond Road  	 Thursday
Strathearn Place  	 Wednesday
Strathearn Road  	 Wednesday
Stuart Crescent  	 Friday
Stuart Green  	 Friday
Stuart Park  	 Friday
Stuart Square  	 Friday
Stuart Wynd  	 Friday
Succoth Avenue  	 Friday
Succoth Gardens  	 Friday
Succoth Park  	 Friday
Succoth Place  	 Friday
Suffolk Road  	 Wednesday
Suffolk Road Lane  	 Wednesday
Summerbank  	 Tuesday
Summerfield Gardens  	 Tuesday
Summerfield Place  	 Tuesday
Summerside Place  	 Tuesday
Summerside Street  	 Tuesday
Summertrees Court  	 Friday
Sunbury Mews  	 Friday
Sunbury Place  	 Friday
Sunbury Place  	 Thursday
Sunbury Street  	 Friday
Sunnyside  	 Thursday
Sunnyside  	 Tuesday
Sutherland Street  	 Friday
Swan Spring Avenue  	 Thursday
Swanfield  	 Tuesday
Swanston Avenue  	 Thursday
Swanston Crescent  	 Thursday
Swanston Drive  	 Thursday
Swanston Gardens  	 Thursday
Swanston Green  	 Thursday
Swanston Grove  	 Thursday
Swanston Loan  	 Thursday
Swanston Muir  	 Thursday
Swanston Park  	 Thursday
Swanston Place  	 Thursday
Swanston Road  	 Thursday
Swanston Row  	 Thursday
Swanston Terrace  	 Thursday
Swanston View  	 Thursday
Swanston Village  	 Thursday
Swanston Way  	 Thursday
Sycamore Gardens  	 Wednesday
Sycamore Terrace  	 Wednesday
Sydney Park  	 Tuesday
Sydney Place  	 Tuesday
Sydney Terrace  	 Tuesday
Sylvan Place  	 Wednesday
Syme Crescent  	 Wednesday
Syme Place  	 Wednesday
Syme Rigg  	 Wednesday
Talisman Place  	 Thursday
Talla Street  	 Thursday
Tansy Street  	 Wednesday
Tantallon Place  	 Wednesday
Telford Drive  	 Tuesday
Telford Gardens  	 Tuesday
Telford Place  	 Tuesday
Telford Road  	 Tuesday
Templar Crescent  	 Thursday
Templar'S Cramond  	 Thursday
Temple Drive  	 Thursday
Temple Park Crescent  	 Wednesday
Temple Place  	 Thursday
Templeland Grove  	 Friday
Templeland Road  	 Friday
Tennant Street  	 Tuesday
Terrars Croft  	 Wednesday
Teviotdale Place  	 Tuesday
The Bowling Green  	 Tuesday
The Causeway  	 Friday
The Cedars  	 Wednesday
The Crescent  	 Wednesday
The Gallolee  	 Wednesday
The Lade  	 Wednesday
The Limes  	 Wednesday
The Loan  	 Thursday
The Murrays  	 Thursday
The Murrays Brae  	 Thursday
The North Walk  	 Wednesday
The Paddockholm  	 Friday
The Pottery  	 Friday
The Quilts  	 Tuesday
The Spinney  	 Thursday
The Square  	 Thursday
The Steils  	 Wednesday
The Vennel  	 Thursday
The Wisp  	 Friday
Thirlestane Lane  	 Wednesday
Thomson Crescent  	 Wednesday
Thomson Drive  	 Wednesday
Thomson Grove  	 Wednesday
Thomson Place  	 Thursday
Thomson Road  	 Wednesday
Thorburn Grove  	 Wednesday
Thorburn Road  	 Wednesday
Thorntree Street  	 Tuesday
Thornville Terrace  	 Tuesday
Thorters Place  	 Thursday
Threipmuir Avenue  	 Wednesday
Threipmuir Gardens  	 Wednesday
Threipmuir Place  	 Wednesday
Timber Bush  	 Tuesday
Timber Bush  	 Thursday
Timmins Court  	 Thursday
Tipperlinn Road  	 Wednesday
Tobias Street  	 Friday
Toddshill Road  	 Thursday
Todshaugh Gardens  	 Thursday
Tor Lane  	 Thursday
Torduff Road  	 Wednesday
Tormain Bank  	 Thursday
Tormain Drive  	 Thursday
Torphichen Street  	 Tuesday
Torphin Bank  	 Wednesday
Torphin Road  	 Wednesday
Torrance Park  	 Friday
Torrance Row  	 Wednesday
Torwood Crescent  	 Wednesday
Toward Court  	 Thursday
Tower Street  	 Tuesday
Trafalgar Lane  	 Tuesday
Traquair Park East  	 Friday
Traquair Park West  	 Friday
Trench Knowe  	 Thursday
Tressilian Gardens  	 Thursday
Trinity Grove  	 Tuesday
Trinity Mains  	 Tuesday
Trinity Road  	 Tuesday
Trinity Way  	 Tuesday
Trotter Haugh  	 Wednesday
Tryst Park  	 Thursday
Tudsbery Avenue  	 Friday
Turner Avenue  	 Wednesday
Turner Park  	 Wednesday
Turnhouse Farm Road  	 Thursday
Turnhouse Road  	 Thursday
Tweedie Lane  	 Wednesday
Tweedsmuir Drive  	 Thursday
Tweedsmuir Gait  	 Thursday
Tyler'S Acre Avenue  	 Wednesday
Tyler'S Acre Gardens  	 Wednesday
Tyler'S Acre Road  	 Wednesday
Tytler Gardens  	 Friday
Tytler Gardens  	 Thursday
Ulster Crescent  	 Friday
Ulster Drive  	 Friday
Ulster Gardens  	 Friday
Ulster Grove  	 Friday
Ulster Terrace  	 Friday
Umbrella Pine Terrace  	 Friday
Underwoods Grove  	 Wednesday
Union Street  	 Tuesday
Upper Coltbridge Terrace  	 Friday
Upper Craigour  	 Thursday
Upper Craigour Way  	 Thursday
Upper Cramond Court  	 Thursday
Upper Dean Terrace  	 Friday
Upper Deanpark Farm  	 Wednesday
Upper Gilmore Place  	 Tuesday
Upper Gilmore Terrace  	 Tuesday
Upper Gray Street  	 Friday
Upper Hermitage  	 Tuesday
Upper Hermitage  	 Thursday
Vanburgh Place  	 Tuesday
Vandeleur Avenue  	 Tuesday
Vandeleur Grove  	 Tuesday
Vandeleur Place  	 Tuesday
Veitch'S Square  	 Friday
Ventnor Place  	 Wednesday
Ventnor Terrace  	 Wednesday
Venturefair Drive  	 Thursday
Vernon Cottages  	 Friday
Vexhim Park  	 Friday
Victor Park Terrace  	 Friday
Viewfield Road  	 Wednesday
Viewforth  	 Tuesday
Viewforth Place  	 Thursday
Viewforth Road  	 Thursday
Viewforth Terrace  	 Tuesday
Villa Road  	 Thursday
Violet Terrace  	 Tuesday
Vivian Terrace  	 Tuesday
Wakefield Avenue  	 Tuesday
Walford Drive  	 Friday
Walker Drive  	 Thursday
Walker Street  	 Friday
Walker Terrace  	 Tuesday
Walkers Court  	 Wednesday
Walkers Rigg  	 Wednesday
Walkers Wynd  	 Wednesday
Wallace Gardens  	 Friday
Walter Scott Avenue  	 Friday
Wantonwalls View  	 Friday
Wardie Avenue  	 Tuesday
Wardie Crescent  	 Tuesday
Wardie Dell  	 Tuesday
Wardie Grove  	 Tuesday
Wardie House Lane  	 Tuesday
Wardie Park  	 Tuesday
Wardie Road  	 Tuesday
Wardie Square  	 Tuesday
Wardieburn Drive  	 Tuesday
Wardieburn Place East  	 Tuesday
Wardieburn Place North  	 Tuesday
Wardieburn Place South  	 Tuesday
Wardieburn Place West  	 Tuesday
Wardieburn Road  	 Tuesday
Wardieburn Street East  	 Tuesday
Wardieburn Street West  	 Tuesday
Wardieburn Terrace  	 Tuesday
Wardiefield  	 Tuesday
Warriston Avenue  	 Tuesday
Warriston Crescent  	 Tuesday
Warriston Drive  	 Tuesday
Warriston Farm Road  	 Wednesday
Warriston Gardens  	 Tuesday
Warriston Grove  	 Tuesday
Warriston Road  	 Tuesday
Warriston Terrace  	 Tuesday
Washington Lane  	 Tuesday
Waterfield Road  	 Thursday
Waterfront Avenue  	 Tuesday
Waterson Avenue  	 Friday
Watertoun Road  	 Wednesday
Watt Gardens  	 Friday
Watt Park  	 Friday
Wauchope Crescent  	 Friday
Wauchope Terrace  	 Friday
Waulkmill Loan  	 Wednesday
Weavers Knowe Crescent  	 Wednesday
Weir Street  	 Wednesday
Well Court  	 Friday
Well Spring Close  	 Thursday
Wellflats Road  	 Thursday
Wellhead Close  	 Thursday
Wellingtonia Crescent  	 Thursday
Wemyss Place  	 Tuesday
Wemyss Place Mews  	 Tuesday
Werberside Mews  	 Tuesday
West Annandale Street  	 Tuesday
West Bowling Green Street  	 Tuesday
West Brighton Crescent  	 Friday
West Bryson Road  	 Tuesday
West Caiystane Road  	 Thursday
West Carnethy Avenue  	 Wednesday
West Castle Road  	 Wednesday
West Catherine Place  	 Friday
West Cherrybank  	 Tuesday
West Coates  	 Friday
West Craigie Farm Road  	 Thursday
West Craigs Avenue  	 Thursday
West Craigs Crescent  	 Thursday
West Croft  	 Thursday
West End Place  	 Tuesday
West Fairbrae Crescent  	 Friday
West Fairbrae Drive  	 Friday
West Ferryfield  	 Tuesday
West Gait  	 Wednesday
West Gorgie Place  	 Friday
West Granton Road  	 Tuesday
West Harbour Road  	 Tuesday
West Mains Road  	 Wednesday
West Maitland Street  	 Tuesday
West Mayfield  	 Friday
West Mill Bank  	 Wednesday
West Mill Bank  	 Thursday
West Mill Road  	 Wednesday
West Montgomery Place  	 Tuesday
West Pilton Avenue  	 Tuesday
West Pilton Bank  	 Tuesday
West Pilton Brae  	 Tuesday
West Pilton Crescent  	 Tuesday
West Pilton Crossway  	 Tuesday
West Pilton Drive  	 Tuesday
West Pilton Gardens  	 Tuesday
West Pilton Green  	 Tuesday
West Pilton Grove  	 Tuesday
West Pilton Lea  	 Tuesday
West Pilton Loan  	 Tuesday
West Pilton March  	 Tuesday
West Pilton Park  	 Tuesday
West Pilton Place  	 Tuesday
West Pilton Rise  	 Tuesday
West Pilton Street  	 Tuesday
West Pilton Terrace  	 Tuesday
West Pilton View  	 Tuesday
West Powburn  	 Wednesday
West Relugas Road  	 Wednesday
West Savile Gardens  	 Wednesday
West Savile Road  	 Wednesday
West Savile Terrace  	 Wednesday
West Scotland Street Lane  	 Tuesday
West Shore Road  	 Tuesday
West Silvermills Lane  	 Tuesday
West Stanhope Place  	 Friday
West Telferton  	 Tuesday
West Terrace  	 Thursday
West Tollcross  	 Tuesday
West Werberside  	 Tuesday
West Winnelstrae  	 Tuesday
West Woods  	 Tuesday
Westbank Loan  	 Friday
Westbank Place  	 Friday
Westbank Street  	 Friday
Westburn Avenue  	 Wednesday
Westburn Grove  	 Wednesday
Westburn Middlefield  	 Wednesday
Westburn Park  	 Wednesday
Wester Broom Avenue  	 Wednesday
Wester Broom Drive  	 Wednesday
Wester Broom Gardens  	 Wednesday
Wester Broom Grove  	 Wednesday
Wester Broom Place  	 Wednesday
Wester Broom Terrace  	 Wednesday
Wester Coates Avenue  	 Friday
Wester Coates Gardens  	 Friday
Wester Coates Place  	 Friday
Wester Coates Road  	 Friday
Wester Coates Terrace  	 Friday
Wester Dalmeny Steading  	 Thursday
Wester Drylaw Avenue  	 Tuesday
Wester Drylaw Drive  	 Tuesday
Wester Drylaw Park  	 Tuesday
Wester Drylaw Place  	 Tuesday
Wester Drylaw Row  	 Tuesday
Wester Hailes Park  	 Wednesday
Wester Hailes Road  	 Wednesday
Wester Hill  	 Wednesday
Wester Rigg  	 Wednesday
Wester Rigg  	 Thursday
Wester Row  	 Wednesday
Wester Steil  	 Wednesday
Western Corner  	 Friday
Western Gardens  	 Friday
Western Place  	 Friday
Western Terrace  	 Friday
Westfield Road  	 Friday
Westgarth Avenue  	 Wednesday
Westhall Gardens  	 Tuesday
Westland Cottages  	 Thursday
Westmost Close  	 Tuesday
Wheatlands  	 Thursday
Whins Place  	 Friday
Whinstone Place  	 Thursday
White Dales  	 Thursday
Whiteadder Loan  	 Thursday
Whitehead Grove  	 Thursday
Whitehill Street  	 Friday
Whitehouse Loan  	 Wednesday
Whitehouse Road  	 Thursday
Whitehouse Terrace  	 Wednesday
Whitelaw  	 Wednesday
Whitelaw Crossing Cottage  	 Wednesday
Whitelea Crescent  	 Wednesday
Whitelea Road  	 Wednesday
Whitingford  	 Tuesday
Whitson Crescent  	 Friday
Whitson Grove  	 Friday
Whitson Place East  	 Friday
Whitson Place West  	 Friday
Whitson Road  	 Friday
Whitson Terrace  	 Friday
Whitson Walk  	 Friday
Whitson Way  	 Friday
Wilfrid Terrace  	 Friday
Wilkieston Road  	 Thursday
Wilkinson Drive  	 Thursday
William Black Place  	 Thursday
William Jameson Place  	 Friday
William Street  	 Friday
William Street North East Lane  	 Friday
William Street North East Lane  	 Thursday
William Street North West Lane  	 Friday
William Street South East Lane  	 Friday
William Street South West Lane  	 Friday
Willow Tree Place  	 Wednesday
Willowbrae Avenue  	 Friday
Willowbrae Gardens  	 Friday
Willowbrae Road  	 Friday
Wilson'S Park  	 Friday
Wilton Road  	 Wednesday
Windmill Place  	 Wednesday
Windrush Drive  	 Tuesday
Windsor Place  	 Friday
Windyrig Close  	 Wednesday
Winterburn Place  	 Wednesday
Winton Drive  	 Thursday
Winton Gardens  	 Thursday
Winton Grove  	 Thursday
Winton Loan  	 Thursday
Winton Park  	 Thursday
Winton Terrace  	 Thursday
Wintour Lane  	 Wednesday
Wisp Green  	 Friday
Wolrige Road  	 Thursday
Wolseley Crescent  	 Friday
Wolseley Gardens  	 Friday
Woodbine Terrace  	 Tuesday
Woodfield Avenue  	 Wednesday
Woodfield Park  	 Wednesday
Woodhall Avenue  	 Wednesday
Woodhall Bank  	 Wednesday
Woodhall Drive  	 Wednesday
Woodhall Grove  	 Wednesday
Woodhall Millbrae  	 Wednesday
Woodhall Road  	 Wednesday
Woodhall Terrace  	 Wednesday
Woodlands Grove  	 Friday
Woodside Terrace  	 Friday
Woodstock Place  	 Thursday
Woodville Terrace  	 Tuesday
Woolmet Place  	 Friday
Wyvern Park  	 Wednesday
Yarrow Place  	 Friday
Yewlands Crescent  	 Thursday
Yewlands Gardens  	 Thursday
York Place  	 Tuesday
York Road  	 Tuesday
Yorkston Court  	 Thursday
Young Drive  	 Thursday
Young Street  	 Tuesday
Young Street North Lane  	 Tuesday
Zetland Place  	 Tuesday
Glenbrook Road  	 Wednesday
Kirkliston To Burnshot 0 C157  	 Thursday
Craigs Road 1 - 49  	 Friday
Craigs Road 55 - 93  	 Thursday
Cramond Road North 10 - 14  	 Tuesday
Cramond Road North 16 - 48  	 Thursday
Dalkeith Road 18 - 299  	 Friday
Dalkeith Road 3 - 16  	 Wednesday
East Fettes Avenue 1 - 27  	 Friday
East Fettes Avenue 30 - 52  	 Tuesday
Old Dalkeith Road 217 - 700  	 Thursday
Old Dalkeith Road 7 - 165  	 Friday
Oxgangs Road North 306 - 348  	 Thursday
Oxgangs Road North 5 - 298  	 Wednesday
Pentland Terrace 14 - 100  	 Thursday
Pentland Terrace 7 - 13  	 Wednesday
Redford Road 10 - 139  	 Wednesday
Redford Road 201 - 271  	 Thursday
Restalrig Road South 2 -10  	 Friday
Blinkbonny Road 0 EH14  	 Wednesday
Blinkbonny Road 0 EH4  	 Friday
Bridge Road  	 Wednesday
Bridge Street 0 EH15  	 Friday
Bridge Street 0 EH28  	 Thursday
High Street 0 EH1  	 Wednesday
High Street  	 Thursday
Hope Street 0 EH2  	 Tuesday
Hope Street 0 EH30  	 Thursday
Kirkgate 0 EH6  	 Tuesday
Kirkgate 0 EH14  	 Wednesday
Lochend Road 0 EH28  	 Thursday
Lochend Road 0 EH6  	 Tuesday
Long Dalmahoy Road 0 EH14  	 Wednesday
Long Dalmahoy Road 0 EH27  	 Thursday
Main Street 0 EH14  	 Wednesday
Main Street  	 Thursday
Main Street 0 EH4  	 Tuesday
Manse Road 0 EH12  	 Wednesday
Manse Road 0 EH29  	 Thursday
Pentland Avenue  	 Wednesday
Pentland View 0 EH10  	 Thursday
Pentland View 0 EH14  	 Wednesday
Queensferry Road 0 EH4 1 -244  	 Friday
Queensferry Road 0 EH4 385 - 634  	 Thursday
Station Road 0 EH12  	 Friday
Station Road  	 Thursday
The Glebe 0 EH29 EH30 EH4  	 Thursday
The Green  	 Wednesday
The Green 0 EH4  	 Tuesday
West Woods  	 Thursday
Braid Road Odd 187 - 215 and Even 168 - 220  	 Thursday
Braid Road Odd 7 - 181 and Even 12 - 166  	 Wednesday
Broomhouse Road Even 204 - 358  	 Wednesday
Broomhouse Road Odd 243 -363  	 Friday
Calder Road 0 EH27  	 Thursday
Calder Road Odd 1 - 9 and Even 2 - 370  	 Friday
Calder Road Odd 181 - 509 and Even 372 - 374  	 Wednesday
Craigcrook Road Odd 1 - 161 and Even 2 - 274  	 Friday
Craigcrook Road Odd 163 - 189 and Even 196 - 306  	 Tuesday
Drum Brae Drive Even numbers  	 Thursday
Drum Brae Drive Odd numbers  	 Friday
Drum Brae North  	 Thursday
Drum Brae North 108 and 133  	 Friday
Gilmerton Road  	 Thursday
Gilmerton Road Odd 221 - 281  	 Friday
Restalrig Road  	 Tuesday
Slateford Road Odd 1 - 97 and Even 2 - 84  	 Tuesday
Slateford Road Odd 151 - 185 and Even 104 - 124  	 Friday
Slateford Road Odd 199 - 207 and Even 132 -182  	 Wednesday
St John'S Road Odd 203 - 309  	 Wednesday
St John'S Road Odd 43 - 157 and Even 6 - 204  	 Friday
