Abbey Street  	 thursday-1
Abbotsford Court  	 friday-1
Abbotsford Crescent  	 tuesday-2
Abbotsford Park  	 tuesday-2
Abercorn Avenue  	 wednesday-2
Abercorn Crescent  	 wednesday-2
Abercorn Drive  	 wednesday-2
Abercorn Gardens  	 tuesday-1
Abercorn Grove  	 wednesday-2
Abercorn Road  	 wednesday-2
Abercorn Terrace  	 tuesday-1
Abercromby Place  	 tuesday-2
Abinger Gardens  	 wednesday-1
Achnacarry Street  	 wednesday-2
Adams Well  	 friday-1
Adamslaw Place  	 tuesday-2
Addiston Crescent  	 friday-1
Addiston Farm Road  	 tuesday-1
Addiston Grove  	 friday-1
Addiston Park  	 friday-1
Adelphi Grove  	 friday-2
Adelphi Place  	 friday-2
Adit Place  	 thursday-2
Admiral Terrace  	 wednesday-1
Affleck Court  	 friday-2
Afton Place  	 wednesday-1
Afton Terrace  	 wednesday-1
Ainslie Place  	 wednesday-1
Aitchison's Place  	 friday-2
Alan Breck Gardens  	 thursday-2
Albany Street  	 tuesday-2
Albert Terrace  	 friday-1
Albion Place  	 thursday-1
Albion Road  	 thursday-1
Albion Terrace  	 thursday-1
Alcorn Square  	 wednesday-2
Alderbank Gardens  	 wednesday-1
Alderbank Place  	 wednesday-1
Alderbank Terrace  	 wednesday-1
Alemoor Crescent  	 wednesday-1
Alemoor Park  	 wednesday-1
Alexander Drive  	 friday-2
Alfred Place  	 thursday-1
Allan Park  	 thursday-1
Allan Park Crescent  	 wednesday-1
Allan Park Drive  	 wednesday-1
Allan Park Gardens  	 wednesday-1
Allan Park Loan  	 wednesday-1
Allan Park Road  	 wednesday-1
Allison Place  	 tuesday-2
Alloway Loan  	 wednesday-2
Almond Bank Cottages  	 wednesday-1
Almond Green  	 friday-2
Almond Grove  	 wednesday-1
Almond Square  	 friday-2
Almondbank Terrace  	 wednesday-1
Almondhill  	 tuesday-2
Almondhill Road  	 tuesday-2
Almondhill Steading  	 tuesday-2
Almondside  	 thursday-1
Alnwickhill Court  	 wednesday-2
Alnwickhill Crescent  	 wednesday-2
Alnwickhill Drive  	 wednesday-2
Alnwickhill Gardens  	 wednesday-2
Alnwickhill Grove  	 wednesday-2
Alnwickhill Loan  	 wednesday-2
Alnwickhill Park  	 wednesday-2
Alnwickhill Terrace  	 wednesday-2
Alnwickhill View  	 wednesday-2
Alva Place  	 thursday-1
Andrew Balfour Grove  	 thursday-1
Angle Park Terrace  	 friday-1
Ann Street  	 tuesday-2
Annandale Street  	 thursday-1
Annfield Street  	 tuesday-1
Appin Terrace  	 wednesday-1
Arboretum Place  	 friday-1
Arboretum Road  	 friday-1
Arden Street  	 wednesday-1
Ardmillan Place  	 friday-1
Ardmillan Terrace  	 friday-1
Ardshiel Avenue  	 thursday-2
Argyle Crescent  	 tuesday-1
Argyle Park Terrace  	 wednesday-1
Argyle Place  	 wednesday-1
Argyll Terrace  	 wednesday-1
Arkaig Gardens  	 wednesday-2
Armstrong Road  	 wednesday-2
Arnott Gardens  	 thursday-2
Arrol Place  	 wednesday-1
Ashburnham Gardens  	 wednesday-1
Ashburnham Loan  	 wednesday-1
Ashburnham Road  	 wednesday-1
Ashley Drive  	 friday-1
Ashley Gardens  	 friday-1
Ashley Grange  	 friday-1
Ashley Grove  	 friday-1
Ashley Place  	 friday-1
Ashley Terrace  	 friday-1
Ashton Grove  	 wednesday-2
Ashton Villas  	 wednesday-1
Ashville Terrace  	 thursday-2
Ashwood Gait  	 thursday-2
Atheling Grove  	 tuesday-2
Atholl Terrace  	 wednesday-1
Auchingane  	 friday-1
Auchinleck's Brae  	 tuesday-1
Auldgate  	 tuesday-1
Avenel  	 wednesday-1
Avenue Villas  	 wednesday-2
Avon Grove  	 wednesday-1
Avon Place  	 wednesday-1
Avon Road  	 wednesday-1
Avondale Place  	 tuesday-2
Baberton Avenue  	 tuesday-1
Baberton Crescent  	 tuesday-1
Baberton Loan  	 friday-1
Baberton Mains Avenue  	 wednesday-2
Baberton Mains Bank  	 wednesday-2
Baberton Mains Brae  	 wednesday-2
Baberton Mains Court  	 wednesday-2
Baberton Mains Crescent  	 wednesday-2
Baberton Mains Dell  	 wednesday-2
Baberton Mains Drive  	 wednesday-2
Baberton Mains Gardens  	 wednesday-2
Baberton Mains Green  	 wednesday-2
Baberton Mains Grove  	 wednesday-2
Baberton Mains Hill  	 wednesday-2
Baberton Mains Lea  	 wednesday-2
Baberton Mains Loan  	 wednesday-2
Baberton Mains Park  	 wednesday-2
Baberton Mains Place  	 wednesday-2
Baberton Mains Rise  	 wednesday-2
Baberton Mains Row  	 wednesday-2
Baberton Mains Terrace  	 wednesday-2
Baberton Mains View  	 wednesday-2
Baberton Mains Way  	 wednesday-2
Baberton Mains Wood  	 wednesday-2
Baberton Mains Wynd  	 wednesday-2
Baberton Park  	 tuesday-1
Baberton Square  	 tuesday-1
Back Dean  	 wednesday-1
Backlee  	 wednesday-2
Badger Neuk  	 thursday-2
Badger Way  	 thursday-2
Baileyfield Road  	 tuesday-2
Bailie Grove  	 wednesday-1
Bailie Path  	 thursday-1
Bailie Place  	 wednesday-1
Bailie Terrace  	 wednesday-1
Bain Rigg  	 thursday-2
Bain Street  	 thursday-2
Baird Avenue  	 wednesday-1
Baird Drive  	 wednesday-1
Baird Gardens  	 wednesday-1
Baird Grove  	 wednesday-1
Baird Road  	 wednesday-2
Baird Terrace  	 wednesday-1
Balbirnie Place  	 wednesday-1
Balcarres Street  	 thursday-1
Balcomie Gardens  	 tuesday-2
Balderston Gardens  	 friday-1
Balderston Gardens North  	 friday-1
Balfour Place  	 friday-1
Balfour Street  	 friday-1
Balfron Loan  	 thursday-2
Balgreen Avenue  	 wednesday-1
Balgreen Gardens  	 wednesday-1
Balgreen Park  	 wednesday-1
Ballantyne Lane  	 friday-1
Ballantyne Place  	 friday-1
Balmoral Place  	 tuesday-2
Balmwell Avenue  	 wednesday-2
Balmwell Grove  	 wednesday-2
Balmwell Park  	 wednesday-2
Balmwell Terrace  	 wednesday-2
Balneil Place  	 tuesday-2
Bangholm Avenue  	 tuesday-1
Bangholm Bower Avenue  	 wednesday-1
Bangholm Grove  	 tuesday-1
Bangholm Loan  	 tuesday-1
Bangholm Park  	 tuesday-1
Bangholm Road  	 tuesday-1
Bangholm Terrace  	 friday-1
Bangholm View  	 tuesday-1
Bangholm Villas  	 tuesday-1
Bangor Road  	 friday-1
Bankhead Grove  	 wednesday-1
Bankhead Road  	 tuesday-1
Bannerman Cruick  	 friday-2
Bannerman Terrace  	 friday-2
Barn Park  	 wednesday-2
Barn Park Crescent  	 wednesday-2
Barnie Terrace  	 tuesday-2
Barnshot Road  	 tuesday-2
Barntalloch Court  	 friday-2
Barnton Avenue  	 thursday-1
Barnton Avenue West  	 wednesday-1
Barnton Brae  	 wednesday-1
Barnton Gardens  	 thursday-1
Barnton Grove  	 tuesday-1
Barnton Loan  	 tuesday-1
Barnton Park  	 thursday-1
Barnton Park Avenue  	 tuesday-1
Barnton Park Crescent  	 tuesday-1
Barnton Park Dell  	 tuesday-1
Barnton Park Drive  	 tuesday-1
Barnton Park Gardens  	 tuesday-1
Barnton Park Grove  	 tuesday-1
Barnton Park Place  	 tuesday-1
Barnton Park View  	 tuesday-1
Barnton Park Wood  	 tuesday-1
Barntongate Avenue  	 tuesday-2
Barntongate Drive  	 tuesday-2
Barntongate Terrace  	 tuesday-2
Barnyard Park Crescent  	 friday-1
Barnyard Park Loan  	 friday-1
Barnyard Park Rigg  	 friday-1
Baronscourt Road  	 wednesday-2
Baronscourt Terrace  	 wednesday-2
Barony Street  	 tuesday-2
Barony Terrace  	 friday-2
Bath Place  	 friday-2
Bath Street  	 friday-2
Bathfield  	 friday-1
Bauld Drive  	 thursday-1
Bavelaw Gardens  	 thursday-1
Bavelaw Green  	 thursday-1
Beach Lane  	 friday-2
Beauchamp Grove  	 thursday-2
Beauchamp Road  	 thursday-2
Beaufort Road  	 wednesday-1
Bedford Terrace  	 tuesday-1
Beechmount Crescent  	 wednesday-1
Beechmount Park  	 wednesday-1
Beechwood Mains  	 thursday-1
Beechwood Terrace  	 thursday-2
Belford Avenue  	 thursday-2
Belford Gardens  	 thursday-2
Belford Park  	 tuesday-1
Belford Place  	 wednesday-1
Belford Terrace  	 wednesday-1
Belgrave Crescent  	 thursday-2
Belgrave Crescent Lane  	 thursday-2
Belgrave Gardens  	 friday-2
Belgrave Place  	 thursday-2
Belgrave Road  	 friday-2
Belgrave Terrace  	 friday-2
Belhaven Terrace  	 thursday-1
Bell Place  	 tuesday-2
Bellevue Crescent  	 tuesday-2
Bellevue Gardens  	 thursday-1
Bellevue Grove  	 thursday-1
Bellevue Place  	 thursday-1
Bellevue Road  	 thursday-1
Bellevue Street  	 thursday-1
Bellevue Terrace  	 tuesday-2
Bellfield Lane  	 friday-2
Bellfield Street  	 friday-2
Bellfield Terrace  	 friday-2
Bellrock Park  	 friday-2
Belmont Avenue  	 wednesday-1
Belmont Crescent  	 wednesday-1
Belmont Drive  	 wednesday-1
Belmont Gardens  	 wednesday-1
Belmont Park  	 wednesday-1
Belmont Road  	 tuesday-1
Belmont Terrace  	 thursday-1
Belmont View  	 wednesday-1
Benhar Road  	 thursday-1
Beresford Avenue  	 tuesday-1
Beresford Gardens  	 tuesday-1
Beresford Place  	 tuesday-1
Beresford Terrace  	 tuesday-1
Bethlehem Way  	 wednesday-1
Biggar Road  	 tuesday-1
Bill Douglas Grove  	 thursday-1
Bingham Avenue  	 friday-2
Bingham Broadway  	 friday-2
Bingham Crescent  	 friday-2
Bingham Crossway  	 friday-2
Bingham Drive  	 friday-2
Bingham Medway  	 friday-2
Bingham Place  	 friday-2
Bingham Way  	 friday-2
Blackadder Drive  	 wednesday-1
Blackbarony Road  	 wednesday-2
Blackburn Crag  	 friday-1
Blackchapel Close  	 thursday-1
Blackchapel Road  	 thursday-1
Blacket Avenue  	 thursday-1
Blacket Place  	 thursday-1
Blackford Avenue  	 tuesday-2
Blackford Bank  	 tuesday-2
Blackford Glen Road  	 wednesday-2
Blackford Hill Grove  	 tuesday-2
Blackford Hill Rise  	 tuesday-2
Blackford Hill View  	 tuesday-2
Blackford Road  	 wednesday-1
Blackie Road  	 wednesday-1
Blackthorn Court  	 tuesday-2
Blackwood Crescent  	 wednesday-2
Blaeberry Gardens  	 tuesday-2
Blantyre Terrace  	 tuesday-2
Bleachfield  	 friday-1
Blenheim Place  	 thursday-1
Blinkbonny Avenue  	 thursday-2
Blinkbonny Crescent  	 wednesday-2
Blinkbonny Gardens  	 thursday-2
Blinkbonny Grove  	 wednesday-2
Blinkbonny Grove West  	 wednesday-2
Blinkbonny Terrace  	 wednesday-2
Bluebell Terrace  	 tuesday-2
Bogsmill Road  	 thursday-1
Bonaly Avenue  	 tuesday-2
Bonaly Brae  	 tuesday-2
Bonaly Crescent  	 tuesday-2
Bonaly Drive  	 tuesday-2
Bonaly Gardens  	 tuesday-2
Bonaly Grove  	 tuesday-2
Bonaly Rise  	 tuesday-2
Bonaly Steading  	 tuesday-2
Bonaly Terrace  	 tuesday-2
Bonaly Wester  	 tuesday-2
Bonnington  	 tuesday-1
Bonnington Avenue  	 friday-1
Bonnington Grove  	 thursday-2
Bonnington Terrace  	 friday-1
Bonnybridge Drive  	 thursday-1
Bonnyhaugh Lane  	 friday-1
Boothacre Cottages  	 wednesday-1
Boothacre Lane  	 wednesday-1
Borrowman Square  	 tuesday-2
Borthwick Place  	 wednesday-1
Boswall Avenue  	 thursday-1
Boswall Crescent  	 thursday-1
Boswall Drive  	 thursday-1
Boswall Gardens  	 thursday-1
Boswall Green  	 thursday-1
Boswall Grove  	 thursday-1
Boswall Loan  	 thursday-1
Boswall Parkway  	 friday-2
Boswall Place  	 thursday-1
Boswall Quadrant  	 thursday-1
Boswall Road  	 wednesday-1
Boswall Square  	 thursday-1
Boswall Terrace  	 thursday-1
Bowbridge Crescent  	 wednesday-2
Bowes Place  	 tuesday-2
Bowling Green Road  	 thursday-1
Brae Park  	 tuesday-1
Brae Park Road  	 tuesday-1
Braeburn Drive  	 friday-1
Braefoot Terrace  	 wednesday-2
Braehead Avenue  	 tuesday-1
Braehead Bank  	 tuesday-1
Braehead Crescent  	 tuesday-1
Braehead Drive  	 tuesday-1
Braehead Grove  	 tuesday-1
Braehead Loan  	 tuesday-1
Braehead Park  	 tuesday-1
Braehead Road  	 tuesday-1
Braehead Row  	 tuesday-1
Braehead View  	 tuesday-1
Braid Avenue  	 wednesday-2
Braid Crescent  	 wednesday-2
Braid Farm Road  	 wednesday-2
Braid Hills Approach  	 thursday-2
Braid Hills Avenue  	 wednesday-2
Braid Hills Crescent  	 wednesday-2
Braid Hills Road  	 wednesday-2
Braid Mount  	 thursday-2
Braid Mount Crest  	 thursday-2
Braid Mount Rise  	 thursday-2
Braid Mount View  	 thursday-2
Braidburn Crescent  	 wednesday-2
Braidburn Terrace  	 wednesday-2
Bramble Drive  	 tuesday-2
Bramdean Grove  	 thursday-2
Bramdean Place  	 thursday-2
Bramdean Rise  	 thursday-2
Bramdean View  	 thursday-2
Brand Drive  	 wednesday-1
Brand Gardens  	 wednesday-1
Branders Place  	 tuesday-2
Brandon Terrace  	 friday-1
Breadalbane Terrace  	 wednesday-1
Briarbank Terrace  	 wednesday-1
Brickfield  	 friday-2
Bridge End  	 thursday-1
Bridge Place  	 tuesday-2
Bridge Street  	 wednesday-2
Briery Bauks  	 wednesday-2
Briggers Brae  	 wednesday-1
Briggers Wynd  	 wednesday-1
Brighouse Park Court  	 wednesday-1
Brighouse Park Crescent  	 wednesday-1
Brighouse Park Cross  	 wednesday-1
Brighouse Park Drive  	 wednesday-1
Brighouse Park Gait  	 wednesday-1
Brighouse Park Gardens  	 wednesday-1
Brighouse Park Rigg  	 wednesday-1
Bright Terrace  	 wednesday-1
Bright's Crescent  	 wednesday-2
Brighton Place  	 wednesday-1
Brighton Street  	 thursday-1
Britwell Crescent  	 tuesday-1
Brock View  	 friday-2
Brocken Brigg Road  	 friday-2
Broombank Terrace  	 tuesday-2
Broomburn Grove  	 tuesday-2
Broomfield Crescent  	 thursday-1
Broomhall Avenue  	 tuesday-2
Broomhall Bank  	 tuesday-2
Broomhall Crescent  	 tuesday-2
Broomhall Drive  	 tuesday-2
Broomhall Gardens  	 tuesday-2
Broomhall Loan  	 tuesday-2
Broomhall Park  	 tuesday-2
Broomhall Place  	 tuesday-2
Broomhall Road  	 tuesday-2
Broomhall Terrace  	 tuesday-2
Broomhouse Avenue  	 thursday-2
Broomhouse Bank  	 thursday-2
Broomhouse Cottages  	 thursday-2
Broomhouse Cottages West  	 thursday-2
Broomhouse Court  	 thursday-2
Broomhouse Crescent  	 thursday-2
Broomhouse Drive  	 thursday-2
Broomhouse Gardens  	 thursday-2
Broomhouse Gardens East  	 thursday-2
Broomhouse Gardens West  	 thursday-2
Broomhouse Grove  	 thursday-2
Broomhouse Loan  	 thursday-2
Broomhouse Market  	 thursday-2
Broomhouse Medway  	 thursday-2
Broomhouse Park  	 thursday-2
Broomhouse Path  	 thursday-2
Broomhouse Place North  	 thursday-2
Broomhouse Place South  	 thursday-2
Broomhouse Row  	 thursday-2
Broomhouse Square  	 thursday-2
Broomhouse Street North  	 thursday-2
Broomhouse Street South  	 thursday-2
Broomhouse Terrace  	 thursday-2
Broomhouse Walk  	 thursday-2
Broomhouse Way  	 thursday-2
Broomlea Crescent  	 tuesday-2
Broompark Road  	 tuesday-2
Broomside Terrace  	 thursday-1
Broomyknowe  	 wednesday-1
Brosie Road  	 friday-2
Brougham Place  	 wednesday-1
Brougham Street  	 wednesday-1
Broughton Place  	 tuesday-2
Broughton Place Lane  	 tuesday-2
Broughton Road  	 friday-1
Bruce Street  	 thursday-1
Brunstane Bank  	 tuesday-1
Brunstane Crescent  	 tuesday-1
Brunstane Drive  	 wednesday-1
Brunstane Gardens  	 friday-2
Brunstane Gardens Mews  	 friday-2
Brunstane Mill Road  	 tuesday-1
Brunstane Road North  	 tuesday-1
Brunstane Road South  	 wednesday-1
Brunswick Road  	 thursday-1
Brunswick Street  	 thursday-1
Brunswick Terrace  	 thursday-1
Brunton Gardens  	 thursday-1
Brunton Place  	 thursday-1
Brunton Terrace  	 thursday-1
Bruntsfield Avenue  	 tuesday-2
Bruntsfield Crescent  	 tuesday-2
Bruntsfield Gardens  	 tuesday-2
Bruntsfield Place  	 tuesday-2
Bruntsfield Terrace  	 tuesday-2
Bryce Avenue  	 tuesday-2
Bryce Crescent  	 tuesday-1
Bryce Place  	 tuesday-1
Bryce Road  	 tuesday-1
Bryson Road  	 friday-1
Buccleuch Street  	 thursday-1
Buchanan Street  	 thursday-1
Buckingham Terrace  	 thursday-2
Buckstane Park  	 thursday-2
Buckstone Avenue  	 friday-2
Buckstone Bank  	 friday-2
Buckstone Circle  	 friday-2
Buckstone Close  	 friday-2
Buckstone Court  	 friday-2
Buckstone Crescent  	 friday-2
Buckstone Crook  	 friday-2
Buckstone Dell  	 friday-2
Buckstone Drive  	 friday-2
Buckstone Gardens  	 friday-2
Buckstone Gate  	 friday-2
Buckstone Green  	 friday-2
Buckstone Grove  	 friday-2
Buckstone Hill  	 friday-2
Buckstone Howe  	 friday-2
Buckstone Lea  	 friday-2
Buckstone Loan  	 friday-2
Buckstone Loan East  	 friday-2
Buckstone Neuk  	 friday-2
Buckstone Place  	 friday-2
Buckstone Rise  	 friday-2
Buckstone Road  	 friday-2
Buckstone Row  	 friday-2
Buckstone Shaw  	 friday-2
Buckstone Terrace  	 thursday-2
Buckstone View  	 friday-2
Buckstone Way  	 friday-2
Buckstone Wood  	 friday-2
Buckstone Wynd  	 friday-2
Bughtlin Drive  	 friday-2
Bughtlin Gardens  	 friday-2
Bughtlin Green  	 friday-2
Bughtlin Loan  	 friday-2
Bughtlin Market  	 friday-2
Bughtlin Park  	 friday-2
Bughtlin Place  	 friday-2
Buie Brae  	 thursday-1
Buie Haugh  	 thursday-1
Buie Rigg  	 thursday-1
Bullfinch Row  	 thursday-2
Bullfinch Way  	 thursday-2
Burdiehouse Avenue  	 thursday-2
Burdiehouse Crossway  	 thursday-2
Burdiehouse Drive  	 thursday-2
Burdiehouse Loan  	 thursday-2
Burdiehouse Medway  	 thursday-2
Burdiehouse Place  	 thursday-2
Burdiehouse Road  	 wednesday-2
Burdiehouse Square  	 thursday-2
Burdiehouse Street  	 thursday-2
Burdiehouse Terrace  	 thursday-2
Burgess Road  	 wednesday-1
Burgess Terrace  	 thursday-1
Burghtoft  	 friday-2
Burnbrae  	 friday-2
Burnbrae Avenue  	 friday-2
Burnbrae Drive  	 friday-2
Burnbrae Grove  	 friday-2
Burnbrae Place  	 friday-2
Burndale Place  	 friday-2
Burnhead Crescent  	 wednesday-2
Burnhead Grove  	 wednesday-2
Burnhead Loan  	 wednesday-2
Burnhead Path East  	 wednesday-2
Burnhead Path West  	 wednesday-2
Burns Street  	 thursday-2
Burnside  	 friday-2
Burnside Park  	 thursday-1
Burton Place  	 friday-1
Buteland Road  	 friday-1
Butlaw  	 tuesday-1
Byrehope Way  	 tuesday-2
Caddell's Row  	 wednesday-1
Cadogan Road  	 thursday-2
Caerlaverock Court  	 friday-2
Cairnmuir Road  	 friday-2
Cairns Drive  	 thursday-1
Cairns Gardens  	 thursday-1
Caithness Place  	 tuesday-1
Caiyside  	 thursday-1
Caiystane Avenue  	 thursday-1
Caiystane Crescent  	 thursday-1
Caiystane Drive  	 thursday-1
Caiystane Gardens  	 thursday-1
Caiystane Hill  	 thursday-1
Caiystane Terrace  	 thursday-1
Caiystane View  	 thursday-1
Cakemuir Gardens  	 tuesday-2
Calder Court  	 thursday-2
Calder Crescent  	 thursday-2
Calder Drive  	 thursday-2
Calder Gardens  	 thursday-2
Calder Grove  	 thursday-2
Calder Road Gardens  	 tuesday-2
Calder View  	 thursday-2
Caledonian Crescent  	 tuesday-1
Caledonian Place  	 tuesday-1
Caledonian Road  	 tuesday-1
Cambridge Avenue  	 friday-1
Cambridge Gardens  	 friday-1
Cambusnethan Street  	 thursday-1
Cameron Crescent  	 thursday-1
Cameron House Avenue  	 thursday-1
Cameron March  	 tuesday-1
Cameron Park  	 wednesday-2
Cameron Terrace  	 thursday-1
Cameron Toll Gardens  	 thursday-1
Cammo Bank  	 tuesday-1
Cammo Brae  	 tuesday-1
Cammo Crescent  	 tuesday-1
Cammo Gardens  	 tuesday-1
Cammo Grove  	 tuesday-1
Cammo Hill  	 tuesday-1
Cammo Parkway  	 tuesday-1
Cammo Place  	 tuesday-1
Cammo Road  	 tuesday-1
Cammo Walk  	 tuesday-1
Campbell Avenue  	 tuesday-1
Campbell Road  	 tuesday-1
Camus Avenue  	 thursday-2
Camus Park  	 thursday-2
Camus Road East  	 thursday-2
Camus Road West  	 thursday-2
Canaan Lane  	 wednesday-2
Canalside  	 wednesday-2
Candlemaker's Crescent  	 friday-1
Candlemaker's Park  	 friday-1
Canmore Street  	 wednesday-1
Cannon Wynd  	 friday-1
Canon Street  	 tuesday-2
Capella Gardens  	 tuesday-2
Captain's Drive  	 wednesday-2
Captain's Loan  	 wednesday-2
Captain's Road  	 wednesday-2
Captain's Row  	 wednesday-2
Carberry Place  	 wednesday-1
Carfrae Gardens  	 friday-1
Carfrae Grove  	 friday-1
Carfrae Park  	 friday-1
Carfrae Road  	 friday-1
Cargil Court  	 wednesday-1
Cargil Terrace  	 wednesday-1
Cargilfield View  	 wednesday-1
Carlow Gardens  	 tuesday-2
Carlowrie Avenue  	 tuesday-1
Carlowrie Crescent  	 tuesday-1
Carlton Street  	 thursday-2
Carlton Terrace  	 thursday-1
Carlyle Place  	 thursday-1
Carmel Avenue  	 thursday-1
Carmel Road  	 thursday-1
Carmelite Road  	 wednesday-1
Carnbee Avenue  	 thursday-2
Carnbee Crescent  	 thursday-2
Carnbee Dell  	 thursday-2
Carnbee End  	 thursday-2
Carnbee Park  	 thursday-2
Carnethy Avenue  	 tuesday-2
Caroline Gardens  	 wednesday-2
Caroline Park  	 tuesday-2
Caroline Place  	 wednesday-2
Caroline Terrace  	 wednesday-2
Carrick Knowe Avenue  	 thursday-1
Carrick Knowe Drive  	 thursday-1
Carrick Knowe Gardens  	 thursday-1
Carrick Knowe Grove  	 thursday-1
Carrick Knowe Hill  	 thursday-1
Carrick Knowe Loan  	 thursday-1
Carrick Knowe Parkway  	 thursday-1
Carrick Knowe Place  	 thursday-1
Carrick Knowe Road  	 thursday-1
Carrick Knowe Terrace  	 thursday-1
Carrie Grove  	 tuesday-2
Carter Drive  	 friday-2
Cassidy Wynd  	 friday-1
Castle Avenue  	 tuesday-2
Castle Gogar Rigg  	 tuesday-1
Castlebrae Glebe  	 tuesday-2
Castlebrae Grove  	 tuesday-2
Castlebrae Place  	 tuesday-2
Castlebrae Rigg  	 tuesday-2
Castlebrae Wynd  	 tuesday-2
Castlelaw Road  	 tuesday-2
Castlepark Gait  	 tuesday-2
Castlepark Green  	 tuesday-2
Castleview Avenue  	 tuesday-2
Castleview Grove  	 tuesday-2
Castleview Terrace  	 tuesday-2
Catchilraw Drive  	 wednesday-2
Catelbock Close  	 tuesday-2
Cathcart Place  	 tuesday-1
Catstane Road  	 tuesday-2
Caulderhame Road  	 friday-2
Causewayside  	 tuesday-1
Cavalry Park Drive  	 thursday-2
Chalmers Crescent  	 wednesday-1
Chamberlain Road  	 tuesday-2
Chancelot Grove  	 friday-1
Chapel Street  	 thursday-1
Charterhall Grove  	 tuesday-2
Charterhall Road  	 tuesday-2
Cherry Tree Avenue  	 wednesday-1
Cherry Tree Crescent  	 wednesday-1
Cherry Tree Gardens  	 wednesday-1
Cherry Tree Grove  	 wednesday-1
Cherry Tree Loan  	 wednesday-1
Cherry Tree Park  	 wednesday-1
Cherry Tree Place  	 wednesday-1
Cherry Tree View  	 wednesday-1
Chesser Avenue  	 friday-2
Chesser Cottages  	 friday-2
Chesser Crescent  	 friday-2
Chesser Gardens  	 friday-2
Chesser Grove  	 friday-2
Chesser Loan  	 friday-2
Chester Street  	 tuesday-1
Christian Crescent  	 wednesday-1
Christian Grove  	 wednesday-1
Christie Miller Avenue  	 tuesday-2
Christie Miller Grove  	 tuesday-2
Christie Miller Place  	 tuesday-2
Christie Road  	 friday-2
Church Hill  	 tuesday-2
Churchhill Drive  	 tuesday-2
Circus Lane  	 tuesday-2
Citadel Place  	 friday-1
Clackmae Grove  	 wednesday-2
Clackmae Road  	 wednesday-2
Clapper Lane  	 wednesday-2
Clarebank Crescent  	 wednesday-1
Claremont Bank  	 tuesday-2
Claremont Crescent  	 thursday-1
Claremont Gardens  	 wednesday-1
Claremont Grove  	 tuesday-2
Claremont Park  	 wednesday-1
Claremont Road  	 wednesday-1
Clarence Street  	 tuesday-2
Clarendon Crescent  	 thursday-2
Clarinda Terrace  	 friday-1
Clark Avenue  	 tuesday-1
Clark Place  	 wednesday-1
Claverhouse Drive  	 friday-1
Clayhills Grove  	 thursday-1
Clayhills Park  	 thursday-1
Clearburn Crescent  	 thursday-1
Clearburn Gardens  	 thursday-1
Clearburn Road  	 thursday-1
Cleekim Drive  	 thursday-1
Cleekim Road  	 thursday-1
Cleghorn Road  	 thursday-2
Cleikiminfield  	 thursday-1
Cleikiminrig  	 thursday-1
Cleric's Hill  	 thursday-1
Clermiston Avenue  	 tuesday-2
Clermiston Crescent  	 tuesday-2
Clermiston Drive  	 tuesday-2
Clermiston Gardens  	 tuesday-2
Clermiston Green  	 tuesday-2
Clermiston Grove  	 tuesday-2
Clermiston Hill  	 tuesday-2
Clermiston Loan  	 tuesday-2
Clermiston Medway  	 tuesday-2
Clermiston Park  	 tuesday-2
Clermiston Place  	 tuesday-2
Clermiston Road North  	 tuesday-2
Clermiston Terrace  	 friday-2
Clermiston View  	 tuesday-2
Clerwood Bank  	 wednesday-2
Clerwood Gardens  	 wednesday-2
Clerwood Grove  	 thursday-2
Clerwood Loan  	 wednesday-2
Clerwood Park  	 wednesday-2
Clerwood Place  	 thursday-2
Clerwood Row  	 wednesday-2
Clerwood Terrace  	 thursday-2
Clerwood View  	 thursday-2
Clerwood Way  	 wednesday-2
Clifton Road  	 tuesday-1
Clifton Terrace  	 tuesday-1
Cliftonhall Road  	 tuesday-1
Clinton Road  	 tuesday-2
Clippens Drive  	 thursday-2
Clovenstone Drive  	 wednesday-2
Clovenstone Gardens  	 wednesday-2
Clovenstone Park  	 wednesday-2
Clufflat  	 tuesday-1
Clufflat Brae  	 tuesday-1
Cluny Avenue  	 wednesday-2
Cluny Drive  	 wednesday-2
Cluny Gardens  	 wednesday-2
Cluny Place  	 wednesday-2
Cluny Terrace  	 wednesday-2
Coates Gardens  	 tuesday-1
Cobbler's Close  	 tuesday-1
Cobden Crescent  	 thursday-1
Cobden Road  	 thursday-1
Cobden Terrace  	 wednesday-1
Cochran Terrace  	 tuesday-2
Cochrane Place  	 thursday-2
Cockburn Crescent  	 thursday-1
Cockburnhill Road  	 friday-1
Coillesdene Avenue  	 tuesday-1
Coillesdene Crescent  	 tuesday-1
Coillesdene Drive  	 tuesday-1
Coillesdene Gardens  	 tuesday-1
Coillesdene Grove  	 tuesday-1
Coillesdene Loan  	 tuesday-1
Coillesdene Terrace  	 tuesday-1
Colinton Grove  	 tuesday-1
Colinton Grove West  	 tuesday-1
Colinton Mains Crescent  	 tuesday-1
Colinton Mains Drive  	 tuesday-1
Colinton Mains Gardens  	 tuesday-1
Colinton Mains Green  	 tuesday-1
Colinton Mains Grove  	 tuesday-1
Colinton Mains Loan  	 thursday-1
Colinton Mains Place  	 tuesday-1
Colinton Mains Road  	 tuesday-1
Colinton Mains Terrace  	 tuesday-1
Collier Place  	 tuesday-2
Collins Place  	 tuesday-2
Colmestone Gate  	 thursday-2
Coltbridge Avenue  	 wednesday-1
Coltbridge Gardens  	 wednesday-1
Coltbridge Terrace  	 wednesday-1
Coltbridge Vale  	 wednesday-1
Columba Avenue  	 wednesday-2
Columba Road  	 wednesday-2
Colville Place  	 tuesday-2
Combe Road  	 thursday-2
Comely Bank  	 thursday-2
Comely Bank Avenue  	 thursday-2
Comely Bank Grove  	 thursday-2
Comely Bank Place  	 thursday-2
Comely Bank Place Mews  	 tuesday-2
Comely Bank Road  	 thursday-2
Comely Bank Row  	 thursday-2
Comely Bank Street  	 thursday-2
Comely Bank Terrace  	 thursday-2
Comiston Drive  	 thursday-1
Comiston Gardens  	 thursday-1
Comiston Grove  	 thursday-2
Comiston Place  	 wednesday-2
Comiston Rise  	 thursday-2
Comiston Road  	 thursday-1
Comiston Springs Avenue  	 thursday-2
Comiston Terrace  	 wednesday-2
Comiston View  	 thursday-2
Commercial Street  	 friday-1
Connaught Place  	 friday-1
Considine Gardens  	 thursday-1
Considine Terrace  	 thursday-1
Corbiehill Avenue  	 wednesday-2
Corbiehill Crescent  	 thursday-1
Corbiehill Gardens  	 wednesday-2
Corbiehill Grove  	 wednesday-2
Corbiehill Park  	 wednesday-2
Corbiehill Place  	 thursday-1
Corbiehill Road  	 wednesday-2
Corbiehill Terrace  	 thursday-1
Corbieshot  	 thursday-1
Corbiewynd  	 thursday-1
Cornfield Crescent  	 thursday-2
Cornhill Terrace  	 thursday-2
Corrennie Drive  	 wednesday-2
Corrennie Gardens  	 wednesday-2
Corrigan Street  	 thursday-1
Corslet Crescent  	 tuesday-1
Corslet Road  	 tuesday-1
Corstorphine Bank Avenue  	 wednesday-2
Corstorphine Bank Drive  	 wednesday-2
Corstorphine Bank Terrace  	 wednesday-2
Corstorphine High Street  	 wednesday-2
Corstorphine Hill Avenue  	 friday-2
Corstorphine Hill Crescent  	 friday-2
Corstorphine Hill Gardens  	 friday-2
Corstorphine Hill Road  	 friday-2
Corstorphine House Avenue  	 friday-2
Corstorphine House Terrace  	 friday-2
Corstorphine Park Gardens  	 friday-2
Cotlaws  	 thursday-1
Cottage Green  	 wednesday-1
Cottage Park  	 friday-1
Coulter Crescent  	 thursday-2
Cowan Road  	 friday-1
Cowan's Close  	 thursday-1
Cowgill Gardens  	 thursday-2
Craigcrook Avenue  	 friday-1
Craigcrook Gardens  	 wednesday-2
Craigcrook Grove  	 friday-1
Craigcrook Park  	 friday-1
Craigcrook Place  	 wednesday-2
Craigcrook Square  	 friday-1
Craigcrook Terrace  	 wednesday-2
Craigentarrie Mews  	 wednesday-1
Craigentinny Avenue North  	 wednesday-1
Craigentinny Crescent  	 tuesday-2
Craigentinny Grove  	 tuesday-2
Craigentinny Place  	 friday-2
Craighall Avenue  	 tuesday-1
Craighall Bank  	 tuesday-1
Craighall Crescent  	 tuesday-1
Craighall Gardens  	 tuesday-1
Craighall Road  	 tuesday-1
Craighall Terrace  	 tuesday-1
Craighill Gardens  	 thursday-1
Craighouse Avenue  	 thursday-1
Craighouse Gardens  	 thursday-1
Craighouse Park  	 thursday-1
Craighouse Road  	 thursday-1
Craighouse Terrace  	 thursday-1
Craigievar Square  	 friday-2
Craigievar Wynd  	 friday-2
Craiglea Drive  	 thursday-1
Craiglea Place  	 thursday-1
Craigleith Avenue North  	 wednesday-2
Craigleith Bank  	 wednesday-2
Craigleith Drive  	 wednesday-2
Craigleith Gardens  	 wednesday-2
Craigleith Grove  	 wednesday-2
Craigleith Hill  	 wednesday-2
Craigleith Hill Avenue  	 wednesday-2
Craigleith Hill Crescent  	 wednesday-2
Craigleith Hill Gardens  	 wednesday-2
Craigleith Hill Green  	 wednesday-2
Craigleith Hill Grove  	 wednesday-2
Craigleith Hill Loan  	 wednesday-2
Craigleith Hill Park  	 wednesday-2
Craigleith Hill Row  	 wednesday-2
Craigleith Rise  	 tuesday-1
Craigleith Road  	 wednesday-2
Craigleith View  	 tuesday-1
Craiglockhart Avenue  	 wednesday-1
Craiglockhart Bank  	 wednesday-1
Craiglockhart Crescent  	 wednesday-1
Craiglockhart Dell Road  	 wednesday-1
Craiglockhart Drive North  	 wednesday-1
Craiglockhart Drive South  	 wednesday-1
Craiglockhart Gardens  	 wednesday-1
Craiglockhart Grove  	 wednesday-1
Craiglockhart Loan  	 wednesday-1
Craiglockhart Park  	 wednesday-1
Craiglockhart Place  	 wednesday-1
Craiglockhart Quadrant  	 wednesday-1
Craiglockhart Road  	 wednesday-1
Craiglockhart Terrace  	 friday-1
Craiglockhart View  	 tuesday-1
Craigmillar Castle Avenue  	 tuesday-2
Craigmillar Castle Gardens  	 tuesday-2
Craigmillar Castle Loan  	 tuesday-2
Craigmillar Castle Road  	 tuesday-2
Craigmillar Park  	 tuesday-1
Craigmount Avenue  	 thursday-2
Craigmount Avenue North  	 thursday-2
Craigmount Bank  	 thursday-2
Craigmount Bank West  	 thursday-2
Craigmount Brae  	 thursday-2
Craigmount Court  	 thursday-2
Craigmount Crescent  	 thursday-2
Craigmount Drive  	 thursday-2
Craigmount Gardens  	 thursday-2
Craigmount Grove  	 thursday-2
Craigmount Grove North  	 thursday-2
Craigmount Hill  	 thursday-2
Craigmount Loan  	 thursday-2
Craigmount Park  	 thursday-2
Craigmount Place  	 thursday-2
Craigmount Terrace  	 thursday-2
Craigmount View  	 thursday-2
Craigmount Way  	 thursday-2
Craigmuir Place  	 friday-2
Craigour Avenue  	 friday-1
Craigour Crescent  	 friday-1
Craigour Drive  	 friday-1
Craigour Gardens  	 friday-1
Craigour Grove  	 friday-1
Craigour Loan  	 friday-1
Craigour Terrace  	 friday-1
Craigpark Avenue  	 wednesday-2
Craigpark Crescent  	 wednesday-2
Craigroyston Grove  	 thursday-2
Craigroyston Place  	 thursday-2
Craigs Avenue  	 friday-1
Craigs Bank  	 friday-1
Craigs Crescent  	 friday-1
Craigs Drive  	 friday-2
Craigs Gardens  	 friday-1
Craigs Grove  	 friday-1
Craigs Loan  	 friday-1
Craigs Park  	 friday-2
Cramond Avenue  	 wednesday-1
Cramond Bank  	 wednesday-1
Cramond Bridge  	 tuesday-1
Cramond Crescent  	 wednesday-1
Cramond Gardens  	 wednesday-1
Cramond Glebe Gardens  	 wednesday-1
Cramond Glebe Road  	 wednesday-1
Cramond Glebe Terrace  	 wednesday-1
Cramond Green  	 wednesday-1
Cramond Grove  	 wednesday-1
Cramond Park  	 wednesday-1
Cramond Place  	 wednesday-1
Cramond Regis  	 wednesday-1
Cramond Road North  	 wednesday-1
Cramond Road South  	 thursday-1
Cramond Terrace  	 wednesday-1
Cramond Vale  	 wednesday-1
Cramond Village  	 wednesday-1
Crarae Avenue  	 tuesday-1
Craw Yard Drive  	 friday-1
Craw Yard Place  	 friday-1
Craw's Close  	 wednesday-1
Crawford Gait  	 tuesday-2
Crawford Green  	 tuesday-2
Crawfurd Road  	 tuesday-1
Crewe Bank  	 friday-2
Crewe Crescent  	 friday-2
Crewe Grove  	 friday-2
Crewe Loan  	 friday-2
Crewe Place  	 friday-2
Crewe Road Gardens  	 friday-2
Crewe Road North  	 tuesday-2
Crewe Road West  	 tuesday-2
Crewe Terrace  	 friday-2
Cromwell Place  	 friday-1
Crosswood Avenue  	 thursday-1
Crosswood Crescent  	 thursday-1
Cuddy Lane  	 tuesday-2
Cullet Walk  	 tuesday-2
Cumberland Street  	 tuesday-2
Cumberland Street South East Lane  	 tuesday-2
Cumin Place  	 wednesday-1
Cumlodden Avenue  	 tuesday-1
Cumnor Crescent  	 friday-1
Curriehill Castle Drive  	 wednesday-1
Currievale Drive  	 friday-2
Currievale Farm  	 friday-1
Currievale Park  	 friday-2
Currievale Park Grove  	 friday-2
Daiches Braes  	 wednesday-1
Daisy Terrace  	 wednesday-1
Dalgety Avenue  	 thursday-1
Dalgety Road  	 thursday-1
Dalgety Street  	 thursday-1
Dalhousie Terrace  	 thursday-1
Dalkeith Road  	 thursday-1
Dalkeith Street  	 tuesday-1
Dalmahoy  	 tuesday-1
Dalmahoy Crescent  	 friday-1
Dalmahoy Road  	 wednesday-2
Dalmeny Estate  	 tuesday-1
Dalmeny Road  	 friday-1
Dalmeny Street  	 thursday-1
Dalry Road  	 wednesday-1
Dalrymple Crescent  	 tuesday-1
Dalziel Place  	 thursday-1
Damselfly Road  	 thursday-2
Damselfly View  	 thursday-2
Dania Court  	 tuesday-2
Danube Street  	 thursday-2
Darnaway Street  	 tuesday-2
Darnell Road  	 wednesday-1
Darnley Terrace  	 tuesday-2
Davidson Gardens  	 thursday-1
Davidson Park  	 tuesday-2
Davidson Road  	 tuesday-2
Dean Bank Lane  	 tuesday-2
Dean Park Crescent  	 thursday-2
Dean Park Mews  	 thursday-2
Dean Park Street  	 thursday-2
Dean Path  	 wednesday-1
Dean Street  	 thursday-2
Deanpark Avenue  	 thursday-1
Deanpark Bank  	 thursday-1
Deanpark Brae  	 thursday-1
Deanpark Court  	 thursday-1
Deanpark Crescent  	 thursday-1
Deanpark Gardens  	 thursday-1
Deanpark Grove  	 thursday-1
Deanpark Place  	 thursday-1
Deanpark Square  	 thursday-1
Dechmont Road  	 friday-1
Dell Road  	 thursday-1
Denham Green Avenue  	 wednesday-1
Denham Green Place  	 wednesday-1
Denham Green Terrace  	 wednesday-1
Derby Street  	 thursday-2
Devon Gardens  	 wednesday-1
Devon Place  	 wednesday-1
Dick Place  	 wednesday-1
Dickson Street  	 thursday-1
Dimma Park  	 tuesday-2
Dinmont Drive  	 friday-1
Dochart Drive  	 thursday-2
Dock Street  	 friday-1
Dolphin Avenue  	 wednesday-1
Dolphin Gardens East  	 wednesday-1
Dolphin Gardens West  	 wednesday-1
Dolphin Road  	 wednesday-1
Donaldson Crescent  	 tuesday-1
Double Hedges Park  	 friday-1
Double Hedges Road  	 friday-1
Douglas Crescent  	 tuesday-1
Douglas Gardens  	 wednesday-1
Douglas Terrace  	 wednesday-1
Doune Terrace  	 tuesday-2
Dovecot Grove  	 thursday-2
Dovecot Loan  	 thursday-2
Dovecot Park  	 thursday-2
Dovecot Road  	 tuesday-2
Dowies Mill Lane  	 wednesday-1
Downie Grove  	 friday-2
Downie Terrace  	 friday-2
Dreghorn Drive  	 friday-1
Dreghorn Gardens  	 friday-1
Dreghorn Link  	 friday-1
Dreghorn Loan  	 tuesday-2
Dreghorn Park  	 thursday-1
Dreghorn Place  	 friday-1
Drum Avenue  	 friday-1
Drum Brae Avenue  	 thursday-2
Drum Brae Crescent  	 thursday-2
Drum Brae Gardens  	 thursday-2
Drum Brae Grove  	 thursday-2
Drum Brae Neuk  	 thursday-2
Drum Brae Park  	 thursday-2
Drum Brae Park Approach  	 thursday-2
Drum Brae Place  	 thursday-2
Drum Brae South  	 thursday-2
Drum Brae Terrace  	 thursday-2
Drum Brae Walk  	 thursday-2
Drum Cottages  	 friday-2
Drum Crescent  	 friday-1
Drum Place  	 friday-1
Drum Woods  	 friday-1
Drummond Place  	 tuesday-2
Drumsheugh Gardens  	 tuesday-1
Dryden Gait  	 thursday-1
Dryden Gardens  	 thursday-1
Dryden Place  	 thursday-1
Dryden Street  	 thursday-1
Dryden Terrace  	 thursday-1
Drylaw Avenue  	 wednesday-2
Drylaw Crescent  	 wednesday-2
Drylaw Gardens  	 wednesday-2
Drylaw Green  	 wednesday-2
Drylaw Grove  	 wednesday-2
Drylaw House Gardens  	 friday-2
Drylaw House Paddock  	 friday-2
Duart Crescent  	 thursday-2
Dublin Street  	 tuesday-2
Dublin Street Lane North  	 tuesday-2
Dublin Street Lane South  	 tuesday-2
Duddingston Avenue  	 thursday-2
Duddingston Crescent  	 wednesday-1
Duddingston Gardens North  	 friday-2
Duddingston Gardens South  	 friday-2
Duddingston Grove East  	 friday-2
Duddingston Grove West  	 friday-2
Duddingston Loan  	 thursday-2
Duddingston Mains Cottages  	 wednesday-1
Duddingston Mills  	 thursday-2
Duddingston Park  	 wednesday-1
Duddingston Park South  	 thursday-1
Duddingston Rise  	 friday-2
Duddingston Road  	 thursday-2
Duddingston Row  	 friday-2
Duddingston Square East  	 friday-2
Duddingston Square West  	 friday-2
Duddingston View  	 friday-2
Dudgeon Place  	 tuesday-2
Dudley Avenue  	 friday-1
Dudley Bank  	 friday-1
Dudley Crescent  	 friday-1
Dudley Gardens  	 friday-1
Dudley Grove  	 friday-1
Dudley Terrace  	 friday-1
Duff Street  	 tuesday-1
Duke Street  	 wednesday-1
Dumbeg Park  	 wednesday-2
Dumbryden Gardens  	 wednesday-2
Duncan Street  	 tuesday-1
Dundas Avenue  	 wednesday-1
Dundas Home Farm  	 tuesday-1
Dundas Place  	 tuesday-2
Dundas Street  	 tuesday-2
Dundee Terrace  	 friday-1
Dundrennan Cottages  	 wednesday-2
Dunedin Street  	 friday-1
Dunipace Road  	 friday-1
Dunkeld Street  	 tuesday-2
Dunlaw Wynd  	 thursday-2
Dunnet Grove  	 thursday-2
Dunnikier Way  	 wednesday-2
Dunollie Court  	 friday-2
Dunrobin Place  	 tuesday-2
Dunsmuir Court  	 wednesday-2
Duntreath Place  	 tuesday-2
Duntreath Road  	 tuesday-2
Dunvegan Court  	 wednesday-1
Durar Drive  	 thursday-2
Durham Avenue  	 friday-2
Durham Drive  	 friday-2
Durham Gardens North  	 friday-2
Durham Gardens South  	 friday-2
Durham Grove  	 friday-2
Durham Place East  	 friday-2
Durham Road  	 friday-2
Durham Road South  	 friday-2
Durham Square  	 friday-2
Durham Terrace  	 thursday-2
Durie Loan  	 thursday-2
Durward Grove  	 friday-1
East Barnton Avenue  	 thursday-1
East Barnton Gardens  	 thursday-1
East Brighton Crescent  	 wednesday-1
East Caiystane Place  	 thursday-1
East Caiystane Road  	 thursday-1
East Camus Place  	 thursday-2
East Castle Road  	 tuesday-2
East Champanyie  	 tuesday-2
East Clapperfield  	 friday-1
East Claremont Street  	 thursday-1
East Comiston  	 thursday-2
East Craigs Rigg  	 friday-1
East Craigs Wynd  	 friday-1
East Croft  	 wednesday-2
East Farm Of Gilmerton  	 friday-1
East Fettes Avenue  	 thursday-2
East Hannahfield  	 friday-1
East Hermitage Place  	 wednesday-1
East Kilngate Place  	 friday-2
East Kilngate Rigg  	 friday-2
East Kilngate Wynd  	 friday-2
East Lillypot  	 tuesday-1
East London Street  	 tuesday-2
East Market Street  	 thursday-1
East Mayfield  	 thursday-1
East Newington Place  	 wednesday-2
East Parkside  	 wednesday-2
East Pilton Farm Crescent  	 thursday-1
East Pilton Farm Wynd  	 thursday-1
East Preston Street  	 wednesday-2
East Restalrig Terrace  	 thursday-2
East Savile Road  	 tuesday-1
East Scotland Street Lane  	 tuesday-2
East Suffolk Park  	 tuesday-1
East Suffolk Road  	 tuesday-1
East Terrace  	 tuesday-1
Easter Belmont Road  	 thursday-1
Easter Currie Court  	 friday-2
Easter Currie Crescent  	 tuesday-1
Easter Currie Place  	 tuesday-1
Easter Currie Terrace  	 tuesday-1
Easter Dalmeny  	 tuesday-1
Easter Drylaw Avenue  	 friday-2
Easter Drylaw Bank  	 friday-2
Easter Drylaw Drive  	 friday-2
Easter Drylaw Gardens  	 friday-2
Easter Drylaw Grove  	 friday-2
Easter Drylaw Loan  	 friday-2
Easter Drylaw Place  	 friday-2
Easter Drylaw View  	 friday-2
Easter Drylaw Way  	 friday-2
Easter Hermitage  	 wednesday-1
Easter Park Drive  	 thursday-1
Easter Road  	 thursday-1
Easter Steil  	 tuesday-1
Easter Warriston  	 tuesday-2
Eastfield  	 tuesday-1
Eastfield Gardens  	 tuesday-1
Eastfield Place  	 tuesday-1
Echline  	 tuesday-1
Echline Drive  	 tuesday-1
Echline Gardens  	 tuesday-1
Echline Green  	 tuesday-1
Echline Grove  	 tuesday-1
Echline Park  	 tuesday-1
Echline Place  	 tuesday-1
Echline Terrace  	 tuesday-1
Echline View  	 tuesday-1
Eden Lane  	 tuesday-2
Eden Terrace  	 tuesday-2
Edgelaw Rigg  	 thursday-2
Edwards Wynd  	 friday-1
Eglinton Crescent  	 tuesday-1
Eildon Street  	 friday-1
Eildon Terrace  	 friday-1
Eilston Drive  	 thursday-1
Eilston Loan  	 thursday-1
Eilston Road  	 thursday-1
Eilston Terrace  	 thursday-1
Elcho Terrace  	 tuesday-1
Elgin Street  	 thursday-1
Elgin Terrace  	 thursday-1
Eliza Wigham Bow  	 thursday-2
Ellangowan Terrace  	 wednesday-2
Ellen's Glen Loan  	 wednesday-2
Ellersly Road  	 tuesday-1
Elliot Gardens  	 wednesday-1
Elliot Park  	 wednesday-1
Elliot Place  	 wednesday-1
Elliot Road  	 wednesday-1
Ellis Drive  	 tuesday-2
Ellis Street  	 wednesday-2
Elm Place  	 thursday-2
Elmwood Terrace  	 thursday-2
Eltringham Gardens  	 friday-2
Eltringham Grove  	 friday-2
Eltringham Terrace  	 wednesday-1
Erroll Drive  	 tuesday-2
Esdaile Bank  	 wednesday-2
Esplanade Terrace  	 friday-2
Essendean Place  	 thursday-2
Essendean Terrace  	 thursday-2
Essex Brae  	 wednesday-1
Essex Park  	 wednesday-1
Essex Road  	 wednesday-1
Esslemont Road  	 tuesday-1
Ethel Terrace  	 thursday-1
Eton Terrace  	 thursday-2
Ettrick Grove  	 tuesday-2
Ettrick Loan  	 friday-1
Ettrick Road  	 friday-1
Ettrickdale Place  	 tuesday-2
Eva Place  	 tuesday-2
Ewerland  	 tuesday-1
Eyre Crescent  	 tuesday-2
Eyre Place  	 tuesday-2
Eyre Place Lane  	 tuesday-2
Fair-a-far  	 wednesday-1
Fair-a-far Shot  	 wednesday-1
Fairbairn Street  	 friday-1
Fairbrae  	 thursday-2
Fairfield Gardens  	 friday-2
Fairford Gardens  	 friday-1
Fairholm Mews  	 wednesday-2
Fairmile Avenue  	 thursday-1
Fala Place  	 wednesday-2
Falcon Avenue  	 tuesday-2
Falcon Court  	 wednesday-2
Falcon Gardens  	 tuesday-2
Falcon Road  	 tuesday-2
Falcon Road West  	 tuesday-2
Falkland Gardens  	 thursday-2
Farquhar Terrace  	 tuesday-1
Farrer Grove  	 tuesday-2
Farrer Terrace  	 tuesday-2
Fauldburn  	 friday-2
Fauldburn Park  	 friday-2
Featherhall Avenue  	 wednesday-2
Featherhall Crescent North  	 wednesday-2
Featherhall Crescent South  	 wednesday-2
Featherhall Grove  	 wednesday-2
Featherhall Place  	 thursday-1
Featherhall Road  	 wednesday-2
Featherhall Terrace  	 thursday-1
Ferguson Rigg  	 thursday-1
Fernieflat Neuk  	 thursday-2
Ferniehill Avenue  	 friday-1
Ferniehill Drive  	 friday-1
Ferniehill Gardens  	 friday-1
Ferniehill Grove  	 friday-1
Ferniehill Place  	 friday-1
Ferniehill Road  	 friday-1
Ferniehill Square  	 friday-1
Ferniehill Street  	 friday-1
Ferniehill Terrace  	 friday-1
Ferniehill Way  	 friday-1
Fernielaw Avenue  	 tuesday-2
Fernieside Avenue  	 friday-1
Fernieside Crescent  	 friday-1
Fernieside Drive  	 friday-1
Fernieside Gardens  	 friday-1
Fernieside Grove  	 friday-1
Fernieside Place  	 friday-1
Ferrier Medway  	 friday-2
Ferry Gait Drive  	 thursday-2
Ferry Gait Gardens  	 thursday-2
Ferry Gait Walk  	 thursday-2
Ferry Road  	 friday-1
Ferry Road Avenue  	 friday-2
Ferry Road Drive  	 friday-2
Ferry Road Gardens  	 friday-2
Ferry Road Grove  	 friday-2
Ferry Road Place  	 friday-2
Ferryburn  	 wednesday-1
Ferryburn Green  	 wednesday-1
Ferryfield  	 thursday-1
Ferrymuir Lane  	 wednesday-1
Fettes Rise  	 friday-1
Fettes Row  	 tuesday-2
Fillyside Avenue  	 tuesday-2
Fillyside Road  	 tuesday-2
Fillyside Terrace  	 tuesday-2
Findhorn Place  	 tuesday-1
Findlay Avenue  	 wednesday-1
Findlay Cottages  	 tuesday-1
Findlay Gardens  	 tuesday-1
Findlay Grove  	 tuesday-1
Findlay Medway  	 tuesday-1
Fingal Place  	 wednesday-1
Finlaggan Court  	 friday-2
Fireclay Walk  	 thursday-1
Firrhill Crescent  	 tuesday-1
Firrhill Loan  	 tuesday-1
Firrhill Park  	 wednesday-1
Fisher Place  	 wednesday-2
Fishwives Causeway  	 tuesday-2
Fleming Place  	 tuesday-1
Fletcher Crescent  	 friday-1
Flint Terrace  	 tuesday-2
Flockhart Gait  	 thursday-1
Florence Mcneill Street  	 friday-2
Forbes Road  	 tuesday-2
Forbes Street  	 wednesday-2
Ford's Road  	 tuesday-2
Forrester Park Avenue  	 tuesday-2
Forrester Park Drive  	 tuesday-2
Forrester Park Gardens  	 tuesday-2
Forrester Park Green  	 tuesday-2
Forrester Park Grove  	 tuesday-2
Forrester Park Loan  	 tuesday-2
Forrester Road  	 friday-2
Forth Park  	 wednesday-1
Forth Place  	 tuesday-1
Forth Street  	 tuesday-2
Forth Terrace  	 wednesday-1
Forth View Avenue  	 wednesday-1
Forth View Road  	 wednesday-1
Forthview Road  	 wednesday-2
Forthview Terrace  	 wednesday-2
Foulis Crescent  	 tuesday-1
Fountainhall Road  	 tuesday-1
Fowler Terrace  	 friday-1
Fox Covert Avenue  	 thursday-2
Fox Covert Grove  	 thursday-2
Fox Spring Crescent  	 thursday-2
Fox Spring Rise  	 thursday-2
Fraser Avenue  	 thursday-1
Fraser Crescent  	 thursday-1
Fraser Gardens  	 thursday-1
Fraser Grove  	 thursday-1
Freelands Road  	 wednesday-2
Freelands Way  	 wednesday-2
Friary Road  	 tuesday-2
Frogston Avenue  	 tuesday-1
Frogston Gardens  	 tuesday-1
Frogston Grove  	 tuesday-1
Frogston Road East  	 wednesday-2
Frogston Road West  	 tuesday-1
Frogston Terrace  	 tuesday-1
Fyfe Way  	 wednesday-1
Galachlaw Shot  	 tuesday-1
Galachlawside  	 tuesday-1
Galvane Road  	 tuesday-2
Gamekeeper's Loan  	 wednesday-1
Gamekeeper's Park  	 wednesday-1
Gamekeeper's Road  	 wednesday-1
Gardiner Grove  	 wednesday-2
Gardiner Road  	 wednesday-2
Gardiner Terrace  	 wednesday-2
Gardner's Crescent  	 wednesday-1
Garscube Terrace  	 tuesday-1
Garvald Street  	 wednesday-2
Gayfield Square  	 tuesday-2
Gifford Crescent  	 friday-1
Gilberstoun  	 wednesday-1
Gilberstoun Brig  	 wednesday-1
Gilberstoun Loan  	 wednesday-1
Gilberstoun Place  	 wednesday-1
Gilberstoun Wynd  	 wednesday-1
Gillespie Crescent  	 tuesday-2
Gillespie Road  	 thursday-2
Gillespie Street  	 tuesday-2
Gillon Drive  	 friday-1
Gillsland Park  	 friday-1
Gillsland Road  	 friday-1
Gilmerton Dykes Avenue  	 friday-2
Gilmerton Dykes Crescent  	 friday-2
Gilmerton Dykes Drive  	 friday-2
Gilmerton Dykes Gardens  	 friday-2
Gilmerton Dykes Grove  	 friday-2
Gilmerton Dykes Loan  	 friday-2
Gilmerton Dykes Place  	 friday-2
Gilmerton Dykes Road  	 friday-2
Gilmerton Dykes Street  	 friday-2
Gilmerton Dykes Terrace  	 friday-2
Gilmerton Dykes View  	 friday-2
Gilmerton Place  	 friday-2
Gilmerton Station Road  	 friday-2
Gilmore Place  	 tuesday-2
Gilmour Road  	 tuesday-1
Gladhouse Place  	 friday-2
Gladstone Place  	 wednesday-1
Gladstone Terrace  	 wednesday-1
Glebe Gardens  	 thursday-1
Glebe Grove  	 thursday-1
Glebe Road  	 thursday-1
Glebe Terrace  	 thursday-1
Glen Street  	 wednesday-1
Glenallan Drive  	 friday-1
Glenallan Loan  	 friday-1
Glenalmond Place  	 thursday-2
Glenbrook  	 friday-1
Glenbrook Road  	 friday-1
Glencairn Crescent  	 tuesday-1
Glendevon Avenue  	 wednesday-1
Glendevon Gardens  	 thursday-1
Glendevon Grove  	 thursday-1
Glendevon Park  	 wednesday-1
Glendevon Place  	 wednesday-1
Glendevon Road  	 wednesday-1
Glendevon Terrace  	 thursday-1
Glendinning Crescent  	 friday-1
Glendinning Drive  	 thursday-1
Glendinning Place  	 thursday-1
Glendinning Road  	 thursday-1
Glendinning Way  	 thursday-1
Glenfinlas Street  	 wednesday-1
Glengyle Terrace  	 wednesday-1
Glenisla Gardens  	 tuesday-2
Glenisla Gardens Lane  	 tuesday-2
Glenlea Cottages  	 friday-2
Glenlee Avenue  	 thursday-2
Glenlee Gardens  	 thursday-2
Glenlockhart Bank  	 tuesday-1
Glenlockhart Road  	 tuesday-1
Glenlockhart Valley  	 tuesday-1
Glenogle House  	 tuesday-2
Glenogle Place  	 tuesday-2
Glenogle Terrace  	 tuesday-2
Glenorchy Terrace  	 wednesday-2
Glenure Loan  	 thursday-2
Glenvarloch Crescent  	 friday-1
Gloucester Square  	 tuesday-2
Goff Avenue  	 tuesday-2
Gogar Station Road  	 friday-2
Gogarbank  	 tuesday-1
Gogarloch Bank  	 friday-1
Gogarloch Haugh  	 friday-1
Gogarloch Muir  	 friday-1
Gogarloch Road  	 friday-1
Gogarloch Syke  	 friday-1
Gogarmuir Road  	 tuesday-1
Gogarstone Road  	 tuesday-1
Goldenacre Terrace  	 friday-1
Goldeneye Drive  	 thursday-2
Goldeneye Gait  	 thursday-2
Goodtrees Gardens  	 friday-2
Goodtrees Terrace  	 friday-2
Gordon Loan  	 friday-2
Gordon Road  	 friday-2
Gordon Terrace  	 wednesday-2
Gorgie Road  	 friday-2
Gosford Place  	 thursday-2
Gospatric Gardens  	 wednesday-1
Gracemount Avenue  	 wednesday-2
Gracemount Drive  	 wednesday-2
Gracemount House Drive  	 thursday-2
Gracemount Place  	 wednesday-2
Gracemount Road  	 wednesday-2
Gracemount Square  	 wednesday-2
Granby Road  	 tuesday-1
Grandison Drive  	 friday-1
Grange Crescent  	 wednesday-1
Grange Loan Gardens  	 wednesday-1
Grange Road  	 wednesday-1
Grange Terrace  	 wednesday-1
Grant Avenue  	 tuesday-2
Granton Crescent  	 friday-2
Granton Gardens  	 thursday-1
Granton Grove  	 thursday-1
Granton Mains Avenue  	 tuesday-2
Granton Mains Bank  	 tuesday-2
Granton Mains Brae  	 tuesday-2
Granton Mains Court  	 tuesday-2
Granton Mains East  	 tuesday-2
Granton Mains Gait  	 tuesday-2
Granton Mains Vale  	 tuesday-2
Granton Mains Wynd  	 tuesday-2
Granton Medway  	 wednesday-1
Granton Mill Crescent  	 tuesday-2
Granton Mill Drive  	 tuesday-2
Granton Mill March  	 friday-2
Granton Mill Park  	 tuesday-2
Granton Mill Place  	 tuesday-2
Granton Mill Road  	 tuesday-2
Granton Mill West  	 tuesday-2
Granton Park Avenue  	 wednesday-1
Granton Park Avenue North  	 wednesday-1
Granton Place  	 thursday-2
Granton Road  	 wednesday-1
Granton Square  	 wednesday-1
Granton Terrace  	 thursday-2
Granton View  	 thursday-1
Granville Terrace  	 tuesday-2
Grassie Avenue  	 thursday-1
Gray's Loan  	 friday-1
Great Carleton Place  	 tuesday-2
Great Carleton Square  	 tuesday-2
Great King Street  	 tuesday-2
Great Stuart Street  	 wednesday-1
Greenbank Avenue  	 wednesday-2
Greenbank Crescent  	 wednesday-1
Greenbank Drive  	 wednesday-1
Greenbank Gardens  	 wednesday-1
Greenbank Grove  	 wednesday-1
Greenbank Lane  	 wednesday-1
Greenbank Loan  	 wednesday-1
Greenbank Park  	 wednesday-1
Greenbank Place  	 wednesday-2
Greenbank Rise  	 wednesday-1
Greenbank Road  	 wednesday-1
Greenbank Row  	 wednesday-1
Greencraig Drive  	 friday-2
Greendale Park  	 thursday-2
Greendykes Road  	 tuesday-2
Greenend Drive  	 friday-2
Greenend Gardens  	 friday-2
Greenend Grove  	 friday-2
Greenfield Crescent  	 thursday-1
Greenfield Road  	 thursday-1
Greenhill Gardens  	 tuesday-2
Greenhill Park  	 tuesday-2
Greenhill Place  	 tuesday-2
Greenhill Terrace  	 tuesday-2
Greenlaw Hedge  	 wednesday-1
Greenlaw Rig  	 tuesday-1
Greenmantle Loan  	 friday-1
Greenpark  	 friday-2
Greenstone Loan  	 wednesday-2
Greenwell Wynd  	 wednesday-2
Greenwood Close  	 thursday-2
Gretna Mews  	 friday-1
Grierson Avenue  	 thursday-1
Grierson Crescent  	 thursday-1
Grierson Gardens  	 thursday-1
Grierson Road  	 thursday-1
Grierson Square  	 thursday-1
Grierson Villas  	 thursday-1
Grieve Crescent  	 thursday-2
Grigor Avenue  	 tuesday-2
Grigor Drive  	 tuesday-2
Grigor Gardens  	 tuesday-2
Grigor Terrace  	 tuesday-2
Groathill Avenue  	 tuesday-2
Groathill Gardens East  	 tuesday-2
Groathill Gardens West  	 tuesday-2
Groathill Loan  	 friday-2
Groathill Road North  	 friday-2
Groathill Road South  	 tuesday-2
Grosvenor Crescent  	 tuesday-1
Grosvenor Gardens  	 tuesday-1
Guardhouse Parade  	 friday-1
Guardwell Crescent  	 friday-2
Guardwell Glen  	 friday-2
Gulliver Street  	 tuesday-2
Gyle Park Gardens  	 friday-1
Gylemuir Road  	 wednesday-2
Hadley Terrace  	 thursday-2
Hailes Approach  	 thursday-2
Hailes Avenue  	 thursday-1
Hailes Bank  	 thursday-2
Hailes Crescent  	 thursday-1
Hailes Gardens  	 thursday-2
Hailes Grove  	 thursday-1
Hailes Park  	 thursday-1
Hailes Street  	 tuesday-2
Hailes Terrace  	 thursday-1
Hailesland Gardens  	 thursday-2
Hailesland Grove  	 thursday-2
Hailesland Place  	 thursday-2
Hainburn Park  	 thursday-1
Hall Terrace  	 wednesday-2
Hallcroft Close  	 wednesday-2
Hallcroft Crescent  	 wednesday-2
Hallcroft Gardens  	 wednesday-2
Hallcroft Green  	 wednesday-2
Hallcroft Neuk  	 wednesday-2
Hallcroft Park  	 wednesday-2
Hallcroft Rise  	 wednesday-2
Hallhead Road  	 wednesday-2
Hallyards Road  	 tuesday-1
Hamilton Drive  	 thursday-2
Hamilton Drive West  	 thursday-2
Hamilton Gardens  	 thursday-2
Hamilton Grove  	 thursday-2
Hamilton Park  	 thursday-2
Hamilton Place  	 tuesday-2
Hamilton Terrace  	 thursday-2
Hamilton's Folly Mews  	 wednesday-2
Hammond Place  	 tuesday-2
Hampton Place  	 tuesday-1
Hampton Terrace  	 tuesday-1
Hapland Bow  	 wednesday-2
Harbour Place  	 friday-2
Harden Place  	 friday-1
Harelaw Road  	 tuesday-2
Harewood Crescent  	 tuesday-2
Harlaw Bank  	 friday-1
Harlaw Gait  	 friday-1
Harlaw March  	 friday-1
Harlaw Road  	 friday-1
Harrison Gardens  	 friday-1
Harrison Road  	 friday-1
Hartington Gardens  	 wednesday-1
Hartington Place  	 wednesday-1
Harvest Road  	 wednesday-2
Harvest Wynd  	 wednesday-2
Hatton Place  	 wednesday-1
Havenfield Mews  	 wednesday-1
Hawkhead Crescent  	 thursday-2
Hawkhead Grove  	 thursday-2
Hawkhill  	 wednesday-1
Hawkhill Avenue  	 wednesday-1
Hawthornbank Place  	 thursday-2
Hawthornbank Terrace  	 thursday-2
Hawthornvale  	 tuesday-1
Hay Avenue  	 tuesday-2
Hay Drive  	 tuesday-2
Hay Gardens  	 tuesday-2
Hay Place  	 tuesday-2
Hay Terrace  	 tuesday-2
Hayfield  	 friday-2
Haystack Park  	 friday-1
Hazelbank Terrace  	 wednesday-1
Hazeldean Terrace  	 friday-1
Hazelwood Grove  	 friday-1
Headrigg Row  	 friday-1
Hedgehog Crescent  	 thursday-2
Hedgehog Walk  	 thursday-2
Helen Crummy Way  	 thursday-1
Henderland Road  	 tuesday-1
Henderson Row  	 tuesday-2
Henderson Terrace  	 friday-1
Henry Ross Place  	 wednesday-1
Hepburn Crescent  	 wednesday-2
Herdrigg Place  	 wednesday-2
Heriot Row  	 tuesday-2
Hermand Crescent  	 friday-2
Hermiston  	 friday-1
Hermiston House Road  	 friday-2
Hermiston Steading  	 friday-1
Hermitage Drive  	 wednesday-2
Hermitage Gardens  	 wednesday-2
Hermitage Park  	 thursday-2
Hermitage Park Grove  	 wednesday-1
Hermitage Park South  	 thursday-2
Hermitage Place  	 wednesday-1
Hermitage Terrace  	 wednesday-2
Hermits Croft  	 wednesday-2
Hewing Place  	 thursday-1
Hewlett Way  	 tuesday-2
Hewson Way  	 tuesday-2
High Buckstone  	 friday-2
High Street  	 thursday-1
Highlea Circle  	 thursday-1
Highlea Grove  	 thursday-1
Hillcoat Loan  	 tuesday-2
Hillpark Avenue  	 friday-1
Hillpark Brae  	 friday-1
Hillpark Court  	 friday-1
Hillpark Crescent  	 friday-1
Hillpark Drive  	 friday-1
Hillpark Gardens  	 friday-1
Hillpark Green  	 friday-1
Hillpark Grove  	 friday-1
Hillpark Loan  	 friday-1
Hillpark Rise  	 friday-1
Hillpark Road  	 friday-1
Hillpark Terrace  	 friday-1
Hillpark Way  	 friday-1
Hillpark Wood  	 friday-1
Hillside Crescent  	 thursday-1
Hillside Street  	 thursday-1
Hillview  	 wednesday-2
Hillview Cottages  	 wednesday-2
Hillview Crescent  	 wednesday-2
Hillview Drive  	 wednesday-2
Hillview Road  	 wednesday-2
Hillview Terrace  	 wednesday-2
Hillwood Avenue  	 wednesday-2
Hillwood Crescent  	 wednesday-2
Hillwood Gardens  	 wednesday-2
Hillwood Rise  	 wednesday-2
Hillwood Road  	 wednesday-2
Hillwood Terrace  	 wednesday-2
Hoffmann Place  	 thursday-1
Hollybank Terrace  	 wednesday-1
Holyrood Park Road  	 wednesday-2
Hope Lane  	 wednesday-1
Hope Lane North  	 friday-2
Hope Street  	 wednesday-1
Hope Terrace  	 tuesday-2
Hopefield Terrace  	 thursday-2
Hopetoun Road  	 wednesday-1
Hopper Gardens  	 thursday-1
Horsburgh Bank  	 friday-1
Horsburgh Gardens  	 friday-1
Horsburgh Grove  	 friday-1
Hoseason Gardens  	 thursday-2
Hosie Rigg  	 thursday-1
House O'hill Avenue  	 wednesday-2
House O'hill Brae  	 wednesday-2
House O'hill Crescent  	 wednesday-2
House O'hill Gardens  	 wednesday-2
House O'hill Green  	 wednesday-2
House O'hill Grove  	 wednesday-2
House O'hill Place  	 wednesday-2
House O'hill Road  	 wednesday-2
House O'hill Row  	 wednesday-2
House O'hill Terrace  	 wednesday-2
Housefield Drive  	 tuesday-2
Howard Place  	 friday-1
Howden Hall Court  	 wednesday-2
Howden Hall Crescent  	 wednesday-2
Howden Hall Drive  	 wednesday-2
Howden Hall Gardens  	 wednesday-2
Howden Hall Loan  	 wednesday-2
Howden Hall Park  	 wednesday-2
Howden Hall Road  	 wednesday-2
Howden Hall Way  	 wednesday-2
Howe Park  	 thursday-1
Howe Street  	 tuesday-2
Hugh Miller Place  	 tuesday-2
Hugh Russell Place  	 wednesday-1
Humbie Farm Road  	 tuesday-1
Humbie Road  	 thursday-1
Hutchison Avenue  	 friday-2
Hutchison Cottages  	 friday-2
Hutchison Crossway  	 friday-2
Hutchison Gardens  	 wednesday-1
Hutchison Grove  	 wednesday-1
Hutchison Loan  	 wednesday-1
Hutchison Medway  	 wednesday-1
Hutchison Park  	 friday-2
Hutchison Place  	 friday-2
Hutchison Road  	 friday-2
Hutchison Terrace  	 friday-2
Hutchison View  	 friday-2
Hyvot Avenue  	 friday-2
Hyvot Bank Avenue  	 friday-2
Hyvot Court  	 friday-2
Hyvot Gardens  	 friday-2
Hyvot Green  	 friday-2
Hyvot Grove  	 friday-2
Hyvot Loan  	 friday-2
Hyvot Mill Drive  	 friday-2
Hyvot Mill Road  	 friday-2
Hyvot Park  	 friday-2
Hyvot Terrace  	 friday-2
Hyvot View  	 friday-2
Inchcolm Terrace  	 wednesday-1
Inchgarvie Park  	 tuesday-1
Inchkeith Avenue  	 wednesday-1
Inchview Terrace  	 tuesday-2
India Place  	 thursday-2
India Street  	 tuesday-2
Industry Home  	 friday-1
Industry Lane  	 friday-1
Inglis Green Road  	 wednesday-2
Inveralmond Drive  	 wednesday-1
Inveralmond Gardens  	 wednesday-1
Inveralmond Grove  	 wednesday-1
Inverleith Avenue  	 friday-1
Inverleith Avenue South  	 friday-1
Inverleith Gardens  	 friday-1
Inverleith Grove  	 friday-1
Inverleith Place  	 friday-1
Inverleith Place Lane  	 tuesday-2
Inverleith Row  	 friday-1
Inverleith Terrace  	 friday-1
Iona Street  	 thursday-1
Ivanhoe Crescent  	 wednesday-2
Ivy Terrace  	 wednesday-1
Jamaica Street South Lane  	 tuesday-2
James Street  	 tuesday-1
Janefield  	 wednesday-2
Jansch Place  	 friday-2
Jardine Place  	 thursday-1
Jeffrey Avenue  	 wednesday-2
Jessfield Terrace  	 thursday-2
John Mason Court  	 wednesday-1
John Paul Jones View  	 friday-1
John Street  	 tuesday-1
John's Place  	 wednesday-1
Johnsburn Green  	 thursday-1
Johnsburn Haugh  	 thursday-1
Johnsburn Park  	 thursday-1
Johnsburn Road  	 thursday-1
Joppa Gardens  	 tuesday-1
Joppa Grove  	 tuesday-1
Joppa Pans  	 tuesday-1
Joppa Park  	 friday-2
Joppa Road  	 tuesday-1
Joppa Station Place  	 tuesday-1
Joppa Terrace  	 tuesday-1
Jordan Lane  	 wednesday-2
Juniper Avenue  	 tuesday-1
Juniper Gardens  	 friday-1
Juniper Grove  	 friday-1
Juniper Lane  	 tuesday-1
Juniper Park Road  	 friday-1
Juniper Place  	 tuesday-1
Juniper Terrace  	 tuesday-1
Juniperlee  	 friday-1
Kaimes Road  	 friday-2
Kane Wynd  	 tuesday-2
Katesmill Road  	 thursday-1
Kedslie Place  	 wednesday-2
Kedslie Road  	 wednesday-2
Keith Crescent  	 wednesday-2
Keith Row  	 wednesday-2
Keith Terrace  	 thursday-1
Kekewich Avenue  	 tuesday-2
Kemp Place  	 tuesday-2
Kempsel Grove  	 thursday-2
Kempston Place  	 wednesday-1
Kenilworth Drive  	 friday-1
Kenmure Avenue  	 wednesday-2
Kew Terrace  	 tuesday-1
Kidlaw Close  	 thursday-2
Kilchurn Court  	 friday-2
Kilgours Bow  	 thursday-1
Kilgraston Road  	 wednesday-1
Killiekrankies Path  	 tuesday-2
Kilmaurs Road  	 thursday-1
Kilmaurs Terrace  	 thursday-1
Kilmorey Place  	 tuesday-2
Kilngate Brae  	 friday-2
Kimmerghame Loan  	 tuesday-2
Kimmerghame Place  	 tuesday-2
Kimmerghame Row  	 tuesday-2
Kimmerghame View  	 tuesday-2
Kinellan Gardens  	 tuesday-1
Kinellan Road  	 tuesday-1
King Edward's Way  	 thursday-1
King Malcolm Close  	 tuesday-1
King's Cramond  	 wednesday-1
King's Meadow  	 thursday-1
King's Road  	 tuesday-2
Kinghorn Place  	 thursday-2
Kings View Close  	 wednesday-2
Kings View Crescent  	 wednesday-2
Kingsburgh Road  	 tuesday-1
Kingsknowe Avenue  	 thursday-2
Kingsknowe Crescent  	 thursday-2
Kingsknowe Drive  	 thursday-2
Kingsknowe Gardens  	 thursday-2
Kingsknowe Grove  	 thursday-2
Kingsknowe Place  	 wednesday-2
Kingsknowe Road North  	 wednesday-2
Kingsknowe Road South  	 thursday-2
Kingsknowe Terrace  	 thursday-2
Kingston Avenue  	 friday-1
Kinleith Mill Road  	 tuesday-1
Kinloch Road  	 friday-2
Kinnear Rise  	 friday-1
Kinnear Road  	 friday-1
Kirk Loan  	 thursday-1
Kirk Park  	 thursday-2
Kirk Street  	 thursday-2
Kirkhill Drive  	 thursday-1
Kirkhill Gardens  	 thursday-1
Kirkhill Road  	 thursday-1
Kirkhill Terrace  	 thursday-1
Kirklands  	 tuesday-2
Kirklands Park Crescent  	 thursday-1
Kirklands Park Gardens  	 thursday-1
Kirklands Park Grove  	 thursday-1
Kirklands Park Rigg  	 thursday-1
Kirklands Park Street  	 thursday-1
Kirkliston Road  	 wednesday-1
Kirkstyle Gardens  	 thursday-1
Kisimul Court  	 friday-2
Klondyke Street  	 thursday-1
Knight Crescent  	 tuesday-2
Ladehead  	 friday-1
Ladiemeadow  	 tuesday-2
Lady Menzies Place  	 thursday-1
Lady Nairne Crescent  	 thursday-2
Lady Nairne Grove  	 thursday-2
Lady Nairne Loan  	 thursday-2
Lady Nairne Place  	 thursday-2
Lady Road  	 tuesday-1
Ladycroft  	 thursday-1
Ladysmith Road  	 tuesday-2
Ladywell Avenue  	 tuesday-2
Ladywell Gardens  	 tuesday-2
Ladywell Road  	 wednesday-2
Laichfield  	 friday-2
Laichpark Loan  	 friday-2
Laichpark Place  	 friday-2
Laichpark Road  	 friday-2
Laing Terrace  	 tuesday-1
Lambsmiln Place  	 tuesday-2
Lammermoor Terrace  	 friday-1
Lamont Place  	 wednesday-2
Lampacre Road  	 thursday-1
Lang Rigg  	 tuesday-1
Langton Road  	 tuesday-2
Langwill Place  	 friday-2
Lansdowne Crescent  	 tuesday-1
Larchfield  	 thursday-1
Larchfield Neuk  	 thursday-1
Larchwood Square  	 thursday-2
Larkfield Gardens  	 wednesday-1
Lasswade Bank  	 wednesday-2
Lasswade Grove  	 wednesday-2
Latch Park  	 friday-1
Lauder Loan  	 wednesday-1
Lauder Road  	 wednesday-1
Lauderdale Street  	 wednesday-1
Laurel Terrace  	 friday-1
Lauriston Farm Road  	 thursday-1
Lauriston Gardens  	 tuesday-2
Lauriston Place  	 tuesday-2
Lauson Place  	 tuesday-2
Laverockbank Avenue  	 tuesday-1
Laverockbank Crescent  	 tuesday-1
Laverockbank Gardens  	 tuesday-1
Laverockbank Grove  	 tuesday-1
Laverockbank Road  	 tuesday-1
Laverockbank Terrace  	 tuesday-1
Laverockdale Crescent  	 tuesday-2
Laverockdale Loan  	 tuesday-2
Laverockdale Park  	 tuesday-2
Law Place  	 friday-2
Lawson Crescent  	 wednesday-1
Leadervale Road  	 wednesday-2
Leadervale Terrace  	 wednesday-2
Leamington Terrace  	 tuesday-2
Learmonth Avenue  	 thursday-2
Learmonth Crescent  	 thursday-2
Learmonth Gardens  	 thursday-2
Learmonth Grove  	 thursday-2
Learmonth Park  	 thursday-2
Learmonth Place  	 thursday-2
Learmonth Terrace  	 thursday-2
Lee Crescent  	 wednesday-1
Lennel Avenue  	 tuesday-1
Lennie Cottages  	 friday-2
Lennox Street  	 thursday-2
Lennymuir  	 friday-2
Lerbar Way  	 thursday-2
Leslie Place  	 thursday-2
Leven Close  	 tuesday-2
Leven Terrace  	 tuesday-2
Lewis Terrace  	 wednesday-1
Liberton Gardens  	 thursday-2
Liberton Place  	 thursday-2
Liberton Tower Lane  	 wednesday-2
Lidgate Shot  	 wednesday-2
Lily Terrace  	 friday-1
Lilyhill Terrace  	 thursday-2
Lime Kilns View  	 thursday-2
Limefield  	 friday-2
Lindean Place  	 thursday-2
Linden Avenue  	 wednesday-2
Lindsay Road  	 friday-1
Lingerwood Lane  	 tuesday-2
Links Gardens  	 wednesday-1
Linn Mill  	 tuesday-1
Lismore Avenue  	 thursday-2
Lismore Crescent  	 thursday-2
Liston Drive  	 thursday-1
Liston Place  	 thursday-1
Liston Road  	 thursday-1
Little France Mills  	 tuesday-2
Little Road  	 thursday-2
Little Street  	 wednesday-1
Littlejohn Avenue  	 tuesday-1
Littlejohn Road  	 tuesday-1
Littlejohn Wynd  	 tuesday-1
Livingstone Place  	 wednesday-1
Lixmount Avenue  	 tuesday-1
Lixmount Gardens  	 tuesday-1
Loaning Road  	 tuesday-1
Loch Place  	 wednesday-1
Lochend Avenue  	 wednesday-1
Lochend Castle Barns  	 thursday-1
Lochend Crescent  	 thursday-1
Lochend Drive  	 thursday-1
Lochend Gardens  	 thursday-1
Lochend Grove  	 thursday-1
Lochend Park  	 wednesday-1
Lochend Quadrant  	 thursday-1
Lochend Road South  	 thursday-1
Lochend Square  	 wednesday-1
Lochiel Crossway  	 wednesday-2
Lockerby Cottages  	 wednesday-2
Lockerby Crescent  	 wednesday-2
Lockerby Grove  	 wednesday-2
Lockharton Avenue  	 tuesday-1
Lockharton Crescent  	 tuesday-1
Lockharton Gardens  	 tuesday-1
Logan Street  	 tuesday-2
Loganlea Avenue  	 tuesday-1
Loganlea Drive  	 tuesday-1
Loganlea Gardens  	 friday-2
Loganlea Loan  	 tuesday-1
Loganlea Place  	 tuesday-1
Loganlea Road  	 tuesday-1
Loganlea Terrace  	 tuesday-1
Logie Green Gardens  	 friday-1
Logie Green Loan  	 friday-1
Logie Green Road  	 friday-1
Lomond Road  	 wednesday-1
London Street  	 tuesday-2
Long Crook  	 tuesday-1
Long Dalmahoy Road  	 friday-1
Longformacus Road  	 thursday-2
Longstone Avenue  	 wednesday-2
Longstone Cottages  	 wednesday-2
Longstone Crescent  	 thursday-1
Longstone Gardens  	 wednesday-2
Longstone Grove  	 wednesday-2
Longstone Road  	 wednesday-2
Longstone Street  	 wednesday-2
Longstone Terrace  	 wednesday-2
Longstone View  	 wednesday-2
Longwall Crescent  	 thursday-1
Lonsdale Terrace  	 wednesday-1
Lorne Place  	 thursday-1
Lorne Street  	 thursday-1
Lovedale Avenue  	 thursday-1
Lovedale Crescent  	 thursday-1
Lovedale Gardens  	 thursday-1
Lovedale Grove  	 thursday-1
Lovedale Road  	 thursday-1
Lower Granton Road  	 wednesday-1
Lower Joppa  	 tuesday-1
Lower London Road  	 thursday-1
Lowrie Gait  	 tuesday-2
Lucas Gardens  	 tuesday-1
Lugton Circle  	 friday-2
Lugton Terrace  	 friday-2
Lumsden Court  	 wednesday-2
Lumsden Square  	 friday-2
Lumsden Wynd  	 friday-2
Lurie Place  	 tuesday-2
Lussielaw Road  	 tuesday-1
Lutton Place  	 thursday-1
Lyall Bow  	 friday-1
Lygon Road  	 tuesday-1
Lynedoch Place  	 wednesday-1
Macdowall Road  	 tuesday-1
Macfie Loan  	 tuesday-2
Macgill Drive  	 thursday-2
Mackinnon Crescent  	 tuesday-2
Macmath Gait  	 wednesday-2
Madeira Place  	 friday-1
Madeira Street  	 friday-1
Magdala Crescent  	 tuesday-1
Magdala Mews  	 tuesday-1
Magdalene Avenue  	 wednesday-1
Magdalene Court  	 thursday-1
Magdalene Gardens  	 thursday-1
Magdalene Loan  	 thursday-1
Magdalene Medway  	 thursday-1
Magdalene Place  	 thursday-1
Maidencraig Court  	 wednesday-2
Maidencraig Crescent  	 wednesday-2
Maidencraig Grove  	 wednesday-2
Maingait Medway  	 thursday-1
Mains Of Craigmillar  	 tuesday-2
Maitland Hog Lane  	 thursday-1
Maitland Road  	 thursday-1
Malachi Close  	 thursday-1
Malachi Gait  	 thursday-1
Malachi Green  	 thursday-1
Malachi Rigg  	 thursday-1
Malbet Park  	 thursday-2
Malbet Wynd  	 thursday-2
Malleny Avenue  	 thursday-1
Malleny Millgate  	 friday-1
Maltman Street  	 wednesday-2
Mannering Place  	 friday-1
Manor Place  	 tuesday-1
Manse Street  	 thursday-1
Mansfield Place  	 tuesday-2
Mansionhouse Road  	 wednesday-1
Maplewood Park  	 thursday-2
March Gait  	 friday-1
March Grove  	 friday-1
March Pines  	 friday-1
March Road  	 friday-1
Marchbank Drive  	 thursday-1
Marchbank Gardens  	 thursday-1
Marchbank Grove  	 thursday-1
Marchbank Place  	 thursday-1
Marchbank Way  	 thursday-1
Marchfield Grove  	 wednesday-2
Marchfield Park  	 wednesday-2
Marchfield Park Lane  	 wednesday-2
Marchfield Terrace  	 friday-1
Marchhall Crescent  	 thursday-1
Marchhall Road  	 thursday-1
Marchmont Crescent  	 wednesday-1
Marchmont Road  	 wednesday-1
Marchmont Street  	 wednesday-1
Marden Place  	 wednesday-2
Margaret Rose Avenue  	 tuesday-1
Margaret Rose Crescent  	 tuesday-1
Margaret Rose Drive  	 tuesday-1
Margaret Rose Loan  	 tuesday-1
Margaret Rose Walk  	 tuesday-1
Margaret Rose Way  	 tuesday-1
Marine Drive  	 tuesday-2
Marionville Avenue  	 tuesday-1
Marionville Crescent  	 tuesday-1
Marionville Drive  	 tuesday-1
Marionville Grove  	 tuesday-1
Marionville Park  	 tuesday-1
Marischal Place  	 wednesday-2
Marlborough Street  	 friday-2
Marmion Crescent  	 friday-1
Marrow Street  	 thursday-2
Marshall Road  	 thursday-1
Martin Street  	 thursday-2
Mary's Place  	 thursday-2
Maryfield  	 thursday-1
Masson Close  	 thursday-1
Matthew Street  	 tuesday-2
Maude Close  	 thursday-1
Maude Park  	 thursday-1
Maude Place  	 thursday-1
Maurice Place  	 tuesday-2
Maxwell Street  	 thursday-1
Mayall Road  	 thursday-2
Maybank Villas  	 friday-2
Maybury Drive  	 friday-2
Mayfield Terrace  	 thursday-1
Mayville Gardens  	 tuesday-1
Mayville Gardens East  	 tuesday-1
Mcarthur Rigg  	 tuesday-2
Mccartney Road  	 thursday-1
Mcdonald Place  	 thursday-1
Mcdonald Road  	 thursday-1
Mclaren Road  	 thursday-1
Mclaren Terrace  	 wednesday-1
Meadow Place  	 wednesday-1
Meadow Place Road  	 wednesday-2
Meadowbank Crescent  	 thursday-2
Meadowbank Terrace  	 thursday-2
Meadowfield Avenue  	 thursday-2
Meadowfield Drive  	 thursday-2
Meadowfield Gardens  	 thursday-2
Meadowfield Terrace  	 thursday-2
Meadowhouse Road  	 thursday-1
Meadowspot  	 thursday-1
Meadowsweet Drive  	 friday-2
Mearenside  	 friday-2
Meggetland Terrace  	 wednesday-2
Melville Terrace  	 wednesday-1
Mentone Avenue  	 friday-2
Mentone Gardens  	 tuesday-1
Mentone Terrace  	 wednesday-2
Merchiston Avenue  	 tuesday-2
Merchiston Bank Avenue  	 tuesday-2
Merchiston Bank Gardens  	 friday-1
Merchiston Crescent  	 tuesday-2
Merchiston Gardens  	 friday-1
Merchiston Mews  	 wednesday-1
Merchiston Park  	 tuesday-2
Merchiston Place  	 tuesday-2
Mertoun Place  	 friday-1
Mid Gillsland Road  	 friday-1
Mid Gogarloch Syke  	 friday-1
Mid Liberton  	 wednesday-2
Mid Steil  	 tuesday-1
Mid Terrace  	 tuesday-1
Middle Norton  	 wednesday-2
Middleby Street  	 tuesday-1
Middleknowe  	 wednesday-2
Middlepark  	 wednesday-2
Middleshot  	 wednesday-2
Midmar Avenue  	 wednesday-2
Midmar Drive  	 wednesday-2
Midmar Gardens  	 wednesday-2
Millar Crescent  	 friday-1
Millar Place Lane  	 wednesday-2
Millbank  	 friday-1
Milligan Drive  	 tuesday-2
Milligan Road  	 tuesday-2
Milnacre  	 friday-1
Milton Crescent  	 friday-2
Milton Drive  	 tuesday-1
Milton Farm Road  	 wednesday-1
Milton Gardens North  	 friday-2
Milton Gardens South  	 friday-2
Milton Road  	 wednesday-1
Milton Road West  	 friday-2
Milton Street  	 thursday-1
Milton Terrace  	 tuesday-1
Mitchell Street  	 wednesday-1
Moat Drive  	 friday-2
Moat Place  	 friday-2
Moat Street  	 friday-2
Moat Terrace  	 friday-2
Moffat Way  	 tuesday-2
Moira Park  	 tuesday-2
Moira Terrace  	 tuesday-2
Moira Terrace Lane  	 friday-2
Moncrieff Terrace  	 wednesday-1
Monkbarns Gardens  	 friday-1
Monmouth Terrace  	 friday-1
Montagu Terrace  	 friday-1
Montague Street  	 wednesday-2
Montgomery Street  	 thursday-1
Montpelier Park  	 tuesday-2
Montpelier Terrace  	 tuesday-2
Montrose Terrace  	 thursday-1
Moodie Place  	 friday-2
Moray Place  	 tuesday-2
Moredun Dell  	 friday-2
Moredun Dykes Road  	 friday-2
Moredun Park Court  	 friday-2
Moredun Park Drive  	 friday-2
Moredun Park Gardens  	 friday-2
Moredun Park Green  	 friday-2
Moredun Park Grove  	 friday-2
Moredun Park Loan  	 friday-2
Moredun Park Road  	 friday-1
Moredun Park Street  	 friday-2
Moredun Park View  	 friday-2
Moredun Park Way  	 friday-2
Moredunvale Green  	 friday-2
Moredunvale Grove  	 friday-2
Moredunvale Loan  	 friday-2
Moredunvale Park  	 friday-2
Moredunvale Place  	 friday-2
Moredunvale Road  	 tuesday-2
Moredunvale View  	 friday-2
Moredunvale Way  	 friday-2
Morham Gait  	 tuesday-1
Morham Gardens  	 tuesday-1
Morham Lea  	 tuesday-1
Morham Park  	 tuesday-1
Morison Gardens  	 wednesday-1
Morningside Drive  	 thursday-1
Morningside Gardens  	 thursday-1
Morningside Grove  	 thursday-1
Morningside Park  	 friday-1
Morningside Place  	 friday-1
Morningside Road  	 tuesday-2
Morningside Terrace  	 friday-1
Mortonhall Park Avenue  	 wednesday-2
Mortonhall Park Bank  	 wednesday-2
Mortonhall Park Crescent  	 wednesday-2
Mortonhall Park Drive  	 wednesday-2
Mortonhall Park Gardens  	 wednesday-2
Mortonhall Park Green  	 wednesday-2
Mortonhall Park Grove  	 wednesday-2
Mortonhall Park Loan  	 wednesday-2
Mortonhall Park Place  	 wednesday-2
Mortonhall Park Terrace  	 wednesday-2
Mortonhall Park View  	 wednesday-2
Mortonhall Park Way  	 wednesday-2
Mortonhall Road  	 tuesday-2
Morven Street  	 thursday-2
Morvenside  	 wednesday-2
Mossgiel Walk  	 friday-1
Moston Terrace  	 wednesday-2
Mottram Road  	 thursday-2
Moubray Grove  	 tuesday-2
Mount Lodge Place  	 friday-2
Mountcastle Bank  	 thursday-2
Mountcastle Crescent  	 wednesday-2
Mountcastle Drive South  	 friday-2
Mountcastle Gardens  	 wednesday-2
Mountcastle Green  	 tuesday-1
Mountcastle Grove  	 wednesday-2
Mountcastle Loan  	 thursday-2
Mountcastle Park  	 wednesday-2
Mountcastle Place  	 tuesday-1
Mountcastle Terrace  	 wednesday-2
Mounthooly Loan  	 tuesday-1
Muir Wood Crescent  	 tuesday-1
Muir Wood Drive  	 tuesday-1
Muir Wood Grove  	 tuesday-1
Muir Wood Place  	 tuesday-1
Muir Wood Road  	 tuesday-1
Muirdale Terrace  	 wednesday-2
Muirend Avenue  	 thursday-2
Muirhouse Avenue  	 thursday-2
Muirhouse Bank  	 thursday-2
Muirhouse Close  	 thursday-2
Muirhouse Drive  	 thursday-2
Muirhouse Gardens  	 thursday-2
Muirhouse Green  	 thursday-2
Muirhouse Grove  	 thursday-2
Muirhouse Loan  	 thursday-2
Muirhouse Medway  	 thursday-2
Muirhouse Park  	 thursday-2
Muirhouse Parkway  	 thursday-2
Muirhouse Place East  	 thursday-2
Muirhouse Place West  	 thursday-2
Muirhouse Terrace  	 thursday-2
Mulberry Place  	 friday-1
Munro Drive  	 tuesday-2
Murieston Crescent  	 wednesday-1
Murray Cottages  	 wednesday-2
Murrayburn Drive  	 thursday-2
Murrayburn Gardens  	 thursday-2
Murrayburn Grove  	 thursday-2
Murrayburn Park  	 thursday-2
Murrayburn Place  	 thursday-2
Murrayfield Avenue  	 tuesday-1
Murrayfield Drive  	 tuesday-1
Murrayfield Gardens  	 tuesday-1
Murrayfield Place  	 tuesday-1
Murrayfield Road  	 tuesday-1
Myreside Road  	 friday-1
Myrtle Terrace  	 wednesday-1
Nantwich Drive  	 tuesday-2
Napier Loan  	 wednesday-1
Napier Road  	 friday-1
Nealands Road  	 tuesday-2
Neidpath Court  	 friday-2
Nellfield  	 friday-1
Nelson Place  	 tuesday-2
Nelson Street  	 tuesday-2
Nether Craigour  	 tuesday-2
Nether Currie Crescent  	 tuesday-1
Nether Currie Place  	 tuesday-1
Nether Currie Road  	 tuesday-1
Netherbank  	 wednesday-2
Netherbank View  	 wednesday-2
Netherby Road  	 wednesday-1
New Lairdship Place  	 thursday-2
New Mart Square  	 friday-2
New Swanston  	 thursday-1
New Tower Place  	 friday-2
Newbattle Terrace  	 tuesday-2
Newbyth Mews  	 friday-2
Newbyth Road  	 friday-2
Newcraighall Drive  	 thursday-1
Newcraighall Road  	 thursday-1
Newhalls Road  	 wednesday-1
Newhaven Main Street  	 tuesday-1
Newhaven Road  	 friday-1
Newington Road  	 wednesday-2
Newlands Park  	 thursday-1
Newliston Road Inner Lodge J & Milrig B & South Lodge E  	 tuesday-1
Newmains Farm Lane  	 thursday-1
Newmains Road  	 thursday-1
Newmills Avenue  	 wednesday-1
Newmills Crescent  	 wednesday-1
Newmills Grove  	 wednesday-1
Newmills Road  	 wednesday-1
Newtoft Street  	 friday-2
Newton Street  	 friday-2
Nichollfield  	 friday-1
Niddrie Cottages  	 thursday-1
Niddrie Farm Grove  	 tuesday-2
Niddrie House Avenue  	 tuesday-2
Niddrie House Drive  	 tuesday-2
Niddrie House Gardens  	 tuesday-2
Niddrie House Park  	 tuesday-2
Niddrie House Square  	 tuesday-2
Niddrie Mains Court  	 tuesday-2
Niddrie Mains Drive  	 tuesday-2
Niddrie Mains Road  	 tuesday-2
Niddrie Marischal Crescent  	 tuesday-2
Niddrie Marischal Drive  	 tuesday-2
Niddrie Marischal Gardens  	 tuesday-2
Niddrie Marischal Green  	 tuesday-2
Niddrie Marischal Grove  	 tuesday-2
Niddrie Marischal Loan  	 tuesday-2
Niddrie Marischal Place  	 tuesday-2
Niddrie Marischal Road  	 tuesday-2
Niddrie Marischal Street  	 tuesday-2
Niddrie Mill Avenue  	 tuesday-2
Niddrie Mill Crescent  	 tuesday-2
Niddrie Mill Drive  	 tuesday-2
Niddrie Mill Place  	 tuesday-2
Niddrie Mill Terrace  	 tuesday-2
Nigel Loan  	 friday-1
Nile Grove  	 wednesday-2
Nisbett Walk  	 friday-2
Noble Place  	 thursday-2
North Bughtlin Bank  	 friday-2
North Bughtlin Brae  	 friday-2
North Bughtlin Gate  	 friday-2
North Bughtlin Neuk  	 friday-2
North Bughtlinfield  	 friday-2
North Bughtlinrig  	 friday-2
North Bughtlinside  	 friday-2
North East Circus Place  	 tuesday-2
North Fort Street  	 friday-1
North Greens  	 thursday-1
North Gyle Avenue  	 friday-1
North Gyle Drive  	 friday-1
North Gyle Farm Court  	 friday-1
North Gyle Farm Lane  	 friday-1
North Gyle Grove  	 friday-1
North Gyle Loan  	 friday-1
North Gyle Park  	 friday-1
North Gyle Road  	 friday-1
North Gyle Terrace  	 friday-1
North Hillhousefield  	 friday-1
North Meggetland  	 tuesday-1
North Park Terrace  	 thursday-2
North Peffer Place  	 tuesday-2
North Platt Crescent  	 wednesday-2
North Platt Gardens  	 wednesday-2
North Street  	 wednesday-2
North West Circus Place  	 tuesday-2
Northfield Avenue  	 wednesday-2
Northfield Broadway  	 wednesday-2
Northfield Circus  	 wednesday-2
Northfield Crescent  	 wednesday-2
Northfield Drive  	 thursday-2
Northfield Farm Avenue  	 wednesday-2
Northfield Farm Road  	 wednesday-2
Northfield Gardens  	 friday-2
Northfield Grove  	 thursday-2
Northfield Park  	 wednesday-2
Northfield Park Grove  	 wednesday-2
Northfield Road  	 wednesday-2
Northfield Square  	 friday-2
Northfield Terrace  	 wednesday-2
Northlawn Terrace  	 thursday-1
Northumberland Street  	 tuesday-2
Oak Lane  	 thursday-2
Oakfield Place  	 wednesday-2
Oaklands Square  	 thursday-2
Oakville Terrace  	 thursday-2
Oakwood Court  	 thursday-2
Observatory Green  	 tuesday-2
Observatory Road  	 tuesday-2
Ochil Court  	 wednesday-1
Ochiltree Gardens  	 wednesday-2
Ogilvie Terrace  	 friday-1
Old Burdiehouse Road  	 thursday-2
Old Church Lane  	 friday-2
Old Farm Avenue  	 tuesday-2
Old Farm Place  	 tuesday-2
Old Kirk Road  	 friday-2
Old Liston Road  	 wednesday-2
Old Mill Lane  	 wednesday-2
Old Newmills Road  	 wednesday-1
Old Quarry Road  	 wednesday-2
Oliver Close  	 thursday-2
Orchard Bank  	 thursday-2
Orchard Brae  	 thursday-2
Orchard Brae Avenue  	 thursday-2
Orchard Brae Gardens  	 thursday-2
Orchard Brae Gardens West  	 thursday-2
Orchard Brae West  	 thursday-2
Orchard Crescent  	 thursday-2
Orchard Drive  	 thursday-2
Orchard Grove  	 thursday-2
Orchard Place  	 thursday-2
Orchard Road  	 thursday-2
Orchard Road South  	 thursday-2
Orchard Terrace  	 thursday-2
Orchardfield Avenue  	 wednesday-2
Orchardhead Loan  	 wednesday-2
Orchardhead Road  	 wednesday-2
Ormelie Terrace  	 tuesday-1
Ormidale Terrace  	 tuesday-1
Ormiston Terrace  	 friday-2
Orrok Park  	 friday-1
Osborne Terrace  	 tuesday-1
Oswald Road  	 tuesday-2
Oswald Terrace  	 thursday-1
Otterburn Park  	 wednesday-1
Overton Farm Road  	 tuesday-1
Owen View  	 tuesday-1
Oxford Street  	 thursday-1
Oxford Terrace  	 thursday-2
Oxgangs Avenue  	 wednesday-1
Oxgangs Bank  	 wednesday-1
Oxgangs Brae  	 thursday-1
Oxgangs Crescent  	 wednesday-1
Oxgangs Farm Avenue  	 friday-1
Oxgangs Farm Drive  	 friday-1
Oxgangs Farm Gardens  	 friday-1
Oxgangs Farm Grove  	 friday-1
Oxgangs Farm Loan  	 friday-1
Oxgangs Farm Terrace  	 friday-1
Oxgangs Gardens  	 wednesday-1
Oxgangs Green  	 wednesday-1
Oxgangs Hill  	 wednesday-1
Oxgangs Loan  	 wednesday-1
Oxgangs Medway  	 thursday-1
Oxgangs Park  	 wednesday-1
Oxgangs Path East  	 thursday-1
Oxgangs Place  	 wednesday-1
Oxgangs Rise  	 wednesday-1
Oxgangs Road  	 thursday-1
Oxgangs Row  	 wednesday-1
Oxgangs Street  	 wednesday-1
Oxgangs Terrace  	 tuesday-1
Oxgangs View  	 thursday-1
Packard Street  	 tuesday-2
Paisley Avenue  	 thursday-2
Paisley Drive  	 thursday-2
Paisley Gardens  	 thursday-2
Paisley Grove  	 thursday-2
Paisley Terrace  	 thursday-2
Palmer Place  	 wednesday-1
Palmer Road  	 wednesday-1
Palmerston Place  	 tuesday-1
Palmerston Place Lane  	 wednesday-1
Palmerston Road  	 wednesday-1
Panmure Place  	 tuesday-2
Pape's Cottages  	 wednesday-1
Park Avenue  	 wednesday-1
Park Crescent  	 thursday-2
Park Gardens  	 thursday-2
Park Grove  	 thursday-2
Park Place  	 tuesday-1
Park Road  	 tuesday-1
Park Terrace  	 thursday-1
Park View  	 thursday-1
Parker Avenue  	 tuesday-2
Parker Terrace  	 tuesday-2
Parkgrove Avenue  	 tuesday-2
Parkgrove Bank  	 tuesday-2
Parkgrove Crescent  	 tuesday-2
Parkgrove Drive  	 tuesday-2
Parkgrove Gardens  	 tuesday-2
Parkgrove Green  	 tuesday-2
Parkgrove Loan  	 tuesday-2
Parkgrove Neuk  	 tuesday-2
Parkgrove Path  	 tuesday-1
Parkgrove Place  	 tuesday-2
Parkgrove Road  	 tuesday-2
Parkgrove Row  	 tuesday-2
Parkgrove Street  	 tuesday-2
Parkgrove Terrace  	 tuesday-2
Parkgrove View  	 tuesday-2
Parkhead Avenue  	 wednesday-2
Parkhead Crescent  	 wednesday-2
Parkhead Drive  	 wednesday-2
Parkhead Gardens  	 wednesday-2
Parkhead Grove  	 wednesday-2
Parkhead Loan  	 wednesday-2
Parkhead Place  	 wednesday-2
Parkhead Street  	 wednesday-2
Parkhead Terrace  	 wednesday-2
Parkhead View  	 thursday-1
Parkside  	 wednesday-2
Parkside Terrace  	 wednesday-2
Parkvale Place  	 thursday-2
Parrotshot  	 thursday-1
Parsons Green Terrace  	 thursday-2
Paterson Place  	 tuesday-2
Path Brae  	 thursday-1
Paties Road  	 wednesday-1
Paton Place  	 thursday-1
Pavilion Crescent  	 tuesday-1
Paxton Wynd  	 thursday-1
Peacocktail Close  	 thursday-1
Pearce Avenue  	 thursday-2
Pearce Grove  	 thursday-2
Pearce Road  	 thursday-2
Peatville Gardens  	 wednesday-2
Peatville Terrace  	 wednesday-2
Peebles Terrace  	 thursday-2
Peel Terrace  	 thursday-1
Peffer Bank  	 tuesday-2
Peggy's Mill Road  	 tuesday-1
Pembroke Place  	 wednesday-1
Peniel Road  	 tuesday-1
Pennywell Cottages  	 tuesday-2
Pennywell Gardens  	 thursday-2
Pennywell Grove  	 thursday-2
Pennywell Medway  	 thursday-2
Pennywell Place  	 thursday-2
Pennywell Road  	 friday-2
Pennywell Villas  	 tuesday-2
Pentland Crescent  	 thursday-2
Pentland Drive  	 wednesday-1
Pentland Gardens  	 thursday-2
Pentland Grove  	 thursday-2
Pentland Place  	 wednesday-1
Pentland Road  	 thursday-2
Pentland Terrace  	 thursday-2
Pentland View Road  	 thursday-1
Pentland Villas  	 tuesday-1
Perdrixknowe  	 tuesday-1
Perth Street  	 tuesday-2
Peveril Terrace  	 friday-1
Philip Terrace  	 wednesday-2
Pier Place  	 tuesday-1
Piersfield Grove  	 tuesday-1
Piersfield Place  	 tuesday-1
Piersfield Terrace  	 tuesday-1
Piershill Terrace  	 wednesday-2
Pikes Pool Drive  	 thursday-1
Pillans Square  	 wednesday-1
Pilmuir Grove  	 friday-1
Pilrig Cottages  	 friday-1
Pilrig Gardens  	 thursday-2
Pilrig Heights  	 thursday-2
Pilrig Street  	 friday-1
Pilton Avenue  	 friday-2
Pilton Crescent  	 friday-2
Pilton Drive  	 friday-2
Pilton Drive North  	 friday-2
Pilton Gardens  	 friday-2
Pilton Loan  	 friday-2
Pilton Park  	 friday-2
Pilton Place  	 friday-2
Pincott Drive  	 thursday-2
Pincott Lane  	 thursday-2
Pinegrove Gardens  	 tuesday-1
Pinkhill  	 friday-2
Pinkhill Park  	 thursday-1
Pirniefield Bank  	 thursday-2
Pirniefield Gardens  	 thursday-2
Pirniefield Grove  	 thursday-2
Pirniefield Place  	 wednesday-1
Pirniefield Terrace  	 wednesday-1
Pitcairn Grove  	 tuesday-1
Pitlochry Place  	 thursday-1
Pitsligo Road  	 tuesday-2
Pitt Street  	 friday-1
Pittville Street  	 tuesday-1
Pleasance  	 wednesday-2
Plewlandcroft  	 wednesday-1
Plewlands Avenue  	 thursday-1
Plewlands Gardens  	 thursday-1
Plewlands Place  	 wednesday-1
Plewlands Terrace  	 thursday-1
Pleydell Place  	 friday-1
Pollard Glebe  	 tuesday-2
Polwarth Crescent  	 friday-1
Polwarth Gardens  	 friday-1
Polwarth Grove  	 friday-1
Polwarth Park  	 friday-1
Polwarth Place  	 friday-1
Polwarth Terrace  	 friday-1
Poplar Lane  	 wednesday-1
Portland Street  	 friday-1
Portmore Drive  	 thursday-2
Portobello High Street  	 friday-2
Powderhall Road  	 friday-1
Prestonfield Avenue  	 thursday-1
Prestonfield Bank  	 thursday-1
Prestonfield Crescent  	 thursday-1
Prestonfield Gardens  	 thursday-1
Prestonfield Road  	 thursday-1
Prestonfield Terrace  	 thursday-1
Priestfield Avenue  	 thursday-1
Priestfield Crescent  	 thursday-1
Priestfield Gardens  	 thursday-1
Priestfield Grove  	 thursday-1
Priestfield Road  	 thursday-1
Priestfield Road North  	 thursday-1
Priesthill Place  	 wednesday-2
Priesthill Street  	 wednesday-2
Primrose Bank Road  	 wednesday-1
Primrose Gardens  	 wednesday-1
Primrose Terrace  	 wednesday-1
Prince Regent Street  	 friday-1
Princess Mary Road  	 tuesday-2
Pringle Drive  	 tuesday-2
Printonan Crescent  	 wednesday-2
Priory Grove  	 wednesday-1
Promenade  	 friday-2
Prospect Bank Crescent  	 wednesday-1
Prospect Bank Gardens  	 wednesday-1
Prospect Bank Grove  	 wednesday-1
Prospect Bank Place  	 wednesday-1
Prospect Bank Road  	 wednesday-1
Prospect Bank Terrace  	 wednesday-1
Provost Milne Grove  	 tuesday-2
Quality Street  	 thursday-1
Quality Street Lane  	 thursday-1
Quarry Cottages  	 thursday-1
Quarrybank  	 wednesday-2
Quarrybank Close  	 wednesday-2
Quarrybank Court  	 wednesday-2
Quarrybank End  	 wednesday-2
Quarrypark Drive  	 wednesday-2
Quarryview  	 wednesday-2
Queen Charlotte Street  	 wednesday-1
Queen Margaret Close  	 tuesday-1
Queen Margaret Drive  	 wednesday-1
Queen's Avenue  	 wednesday-2
Queen's Avenue South  	 wednesday-2
Queen's Bay Crescent  	 wednesday-1
Queen's Crescent  	 thursday-1
Queen's Gardens  	 wednesday-2
Queen's Park Avenue  	 thursday-1
Queen's Road  	 wednesday-2
Queensferry Terrace  	 thursday-2
Quintinshill Place  	 friday-1
Raeburn Place  	 thursday-2
Ramslack Street  	 wednesday-1
Randolph Crescent  	 wednesday-1
Rankeillor Street  	 wednesday-2
Rankin Avenue  	 tuesday-2
Rankin Drive  	 tuesday-2
Rankin Road  	 tuesday-1
Rannoch Grove  	 thursday-2
Rannoch Place  	 thursday-2
Rannoch Road  	 thursday-2
Rannoch Terrace  	 thursday-2
Ransome Gardens  	 thursday-2
Ratho Mains  	 tuesday-1
Ratho Park Road  	 wednesday-2
Rattray Drive  	 tuesday-1
Rattray Grove  	 tuesday-1
Rattray Loan  	 tuesday-1
Rattray Way  	 tuesday-1
Ravelrig Drive  	 friday-1
Ravelrig Gait  	 friday-1
Ravelrig Hill  	 friday-1
Ravelrig Park  	 friday-1
Ravelrig Road  	 friday-1
Ravelrig Wynd  	 friday-1
Ravelston Dykes  	 tuesday-1
Ravelston Dykes Lane  	 thursday-1
Ravelston House Grove  	 wednesday-2
Ravelston House Loan  	 wednesday-2
Ravelston House Park  	 wednesday-2
Ravelston House Road  	 wednesday-2
Ravelston Park  	 tuesday-1
Ravelston Place  	 tuesday-1
Ravelston Rise  	 tuesday-1
Ravelston Terrace  	 tuesday-1
Ravenscroft Gardens  	 friday-2
Ravenscroft Place  	 friday-2
Ravenscroft Street  	 friday-2
Redbraes Grove  	 friday-1
Redbraes Place  	 friday-1
Redford Avenue  	 tuesday-2
Redford Bank  	 friday-1
Redford Crescent  	 tuesday-2
Redford Drive  	 tuesday-2
Redford Gardens  	 friday-1
Redford Grove  	 friday-1
Redford Loan  	 tuesday-2
Redford Neuk  	 friday-1
Redford Place  	 friday-1
Redford Terrace  	 tuesday-2
Redford Walk  	 friday-1
Redgauntlet Terrace  	 friday-1
Redhall Avenue  	 wednesday-2
Redhall Bank Road  	 thursday-2
Redhall Crescent  	 thursday-1
Redhall Drive  	 wednesday-2
Redhall Gardens  	 wednesday-2
Redhall Grove  	 wednesday-2
Redhall House Avenue  	 wednesday-1
Redhall House Close  	 wednesday-1
Redhall House Drive  	 wednesday-1
Redhall Place  	 wednesday-2
Redhall Road  	 wednesday-2
Redhall View  	 thursday-2
Regent Place  	 thursday-1
Regent Street  	 friday-2
Regent Terrace  	 thursday-1
Regis Court  	 wednesday-1
Reid Terrace  	 tuesday-2
Relugas Gardens  	 tuesday-2
Relugas Place  	 tuesday-2
Relugas Road  	 tuesday-2
Restalrig Avenue  	 tuesday-1
Restalrig Circus  	 wednesday-1
Restalrig Crescent  	 wednesday-1
Restalrig Drive  	 tuesday-1
Restalrig Gardens  	 thursday-1
Restalrig Road  	 wednesday-1
Restalrig Square  	 thursday-2
Restalrig Terrace  	 thursday-2
Reynolds Road  	 thursday-2
Riccarton Avenue  	 friday-2
Riccarton Crescent  	 friday-2
Riccarton Drive  	 friday-2
Riccarton Grove  	 friday-2
Riccarton Mains Road  	 friday-2
Richmond Terrace  	 wednesday-1
Riding Park  	 wednesday-1
Rintoul Place  	 tuesday-2
Riselaw Crescent  	 thursday-2
Riselaw Place  	 thursday-2
Riselaw Road  	 thursday-2
Riselaw Terrace  	 thursday-2
Riversdale Crescent  	 wednesday-1
Riversdale Grove  	 wednesday-1
Riversdale Road  	 wednesday-1
Riverside  	 wednesday-2
Robb's Loan  	 friday-2
Robert Burns Drive  	 friday-1
Rocheid Park  	 friday-1
Rochester Terrace  	 tuesday-2
Roddinglaw Road  	 tuesday-1
Rodney Street  	 tuesday-2
Rona Avenue  	 wednesday-2
Rose Lane  	 wednesday-1
Rosebank Cottages  	 wednesday-1
Rosebank Gardens  	 wednesday-1
Rosebank Grove  	 wednesday-1
Rosebank Road  	 wednesday-1
Rosebery Avenue  	 wednesday-1
Rosebery Court  	 wednesday-1
Rosebery Crescent  	 tuesday-1
Rosebery Crescent Lane  	 wednesday-1
Roseburn Avenue  	 tuesday-1
Roseburn Cliff  	 tuesday-1
Roseburn Crescent  	 tuesday-1
Roseburn Drive  	 tuesday-1
Roseburn Place  	 tuesday-1
Roseburn Street  	 tuesday-1
Roseburn Terrace  	 wednesday-1
Rosefield Avenue  	 friday-2
Rosefield Avenue Lane  	 friday-2
Rosefield Place  	 friday-2
Rosefield Street  	 friday-2
Roseneath Street  	 wednesday-1
Roseneath Terrace  	 wednesday-1
Roseville Gardens  	 tuesday-1
Ross Gardens  	 tuesday-1
Ross Place  	 tuesday-1
Ross Road  	 wednesday-2
Rosshill Terrace  	 wednesday-1
Rosslyn Crescent  	 friday-1
Rosslyn Terrace  	 friday-1
Rothesay Terrace  	 tuesday-1
Roull Grove  	 tuesday-2
Roull Place  	 tuesday-2
Roull Road  	 tuesday-2
Rowallan Court  	 friday-2
Rowantree Avenue  	 wednesday-1
Rowantree Grove  	 wednesday-1
Rowieston Drive  	 wednesday-2
Roxburgh Street  	 wednesday-2
Royal Circus  	 tuesday-2
Royal Crescent  	 tuesday-2
Royal Park Terrace  	 thursday-1
Royal Terrace  	 thursday-1
Royston Mains Avenue  	 friday-2
Royston Mains Crescent  	 friday-2
Royston Mains Gardens  	 friday-2
Royston Mains Green  	 friday-2
Royston Mains Place  	 friday-2
Royston Mains Road  	 friday-2
Royston Mains Street  	 friday-2
Royston Terrace  	 friday-1
Russell Place  	 tuesday-1
Rustic Cottages  	 tuesday-2
Rutherford Drive  	 friday-1
Ruthven Place  	 friday-1
Ryehill Avenue  	 thursday-2
Ryehill Gardens  	 thursday-2
Ryehill Grove  	 thursday-2
Ryehill Place  	 thursday-2
Ryehill Terrace  	 thursday-2
Saddle Tree Loan  	 friday-1
Salisbury Road  	 thursday-1
Salmond Place  	 thursday-1
Salvesen Crescent  	 tuesday-2
Salvesen Gardens  	 tuesday-2
Salvesen Grove  	 tuesday-2
Salvesen Terrace  	 tuesday-2
Sandercombe Drive  	 tuesday-2
Sandford Gardens  	 wednesday-1
Sandstone Crescent  	 thursday-1
Sassoon Grove  	 thursday-1
Saughton Avenue  	 friday-2
Saughton Crescent  	 wednesday-1
Saughton Gardens  	 wednesday-1
Saughton Grove  	 wednesday-1
Saughton Loan  	 wednesday-1
Saughton Mains Bank  	 tuesday-2
Saughton Mains Drive  	 wednesday-2
Saughton Mains Gardens  	 tuesday-2
Saughton Mains Grove  	 wednesday-2
Saughton Mains Loan  	 wednesday-2
Saughton Mains Terrace  	 tuesday-2
Saughton Park  	 wednesday-1
Saughton Road North  	 thursday-1
Saughtonhall Avenue  	 wednesday-1
Saughtonhall Avenue West  	 wednesday-1
Saughtonhall Circus  	 wednesday-1
Saughtonhall Crescent  	 wednesday-1
Saughtonhall Drive  	 wednesday-1
Saughtonhall Gardens  	 wednesday-1
Saughtonhall Grove  	 wednesday-1
Saughtonhall Place  	 wednesday-1
Saughtonhall Terrace  	 wednesday-1
Savile Place  	 tuesday-1
Savile Terrace  	 wednesday-2
Saxe-coburg Place  	 tuesday-2
Saxe-coburg Street  	 tuesday-2
Saxe-coburg Terrace  	 tuesday-2
Scald Law Drive  	 tuesday-2
Scanlan Street  	 thursday-1
School Brae  	 wednesday-1
Sciennes Gardens  	 wednesday-1
Sciennes Hill Place  	 wednesday-1
Sciennes Road  	 wednesday-1
Scone Gardens  	 thursday-2
Scotland Street  	 tuesday-2
Scotstoun Avenue  	 tuesday-2
Scotstoun Green  	 tuesday-2
Scotstoun Park  	 tuesday-2
Scott Street  	 tuesday-2
Seacot  	 thursday-2
Seafield Avenue  	 thursday-2
Seafield Road  	 wednesday-1
Seaforth Drive  	 wednesday-2
Seaview Crescent  	 tuesday-1
Seaview Terrace  	 tuesday-1
Seton Place  	 wednesday-1
Shale Road  	 thursday-2
Shandon Crescent  	 wednesday-1
Shandon Place  	 friday-1
Shandon Road  	 wednesday-1
Shandon Street  	 wednesday-1
Shandon Terrace  	 wednesday-1
Shandwick Place  	 wednesday-1
Shanter Way  	 friday-1
Shavelin Drive  	 thursday-1
Shaw's Place  	 thursday-1
Shaw's Street  	 thursday-1
Shaw's Terrace  	 thursday-1
Shearie Knowe Gardens  	 tuesday-2
Shiels Way  	 wednesday-1
Shore Road  	 wednesday-1
Shrub Mount  	 friday-2
Sidings Way  	 friday-2
Sighthill Crescent  	 thursday-2
Sighthill Drive  	 thursday-2
Sighthill Gardens  	 thursday-2
Sighthill Grove  	 thursday-2
Sighthill Loan  	 thursday-2
Sighthill Neuk  	 thursday-2
Sighthill Park  	 thursday-2
Sighthill Place  	 thursday-2
Sighthill Rise  	 thursday-1
Sighthill Road  	 thursday-2
Sighthill Street  	 thursday-2
Sighthill Terrace  	 thursday-2
Silverknowes Avenue  	 thursday-1
Silverknowes Bank  	 thursday-2
Silverknowes Brae  	 thursday-2
Silverknowes Court  	 thursday-2
Silverknowes Crescent  	 thursday-1
Silverknowes Dell  	 thursday-1
Silverknowes Drive  	 thursday-1
Silverknowes Eastway  	 thursday-2
Silverknowes Gardens  	 thursday-2
Silverknowes Green  	 thursday-2
Silverknowes Grove  	 thursday-2
Silverknowes Hill  	 thursday-1
Silverknowes Loan  	 thursday-1
Silverknowes Midway  	 thursday-2
Silverknowes Neuk  	 thursday-1
Silverknowes Parkway  	 thursday-2
Silverknowes Place  	 thursday-2
Silverknowes Road East  	 thursday-2
Silverknowes Road South  	 thursday-1
Silverknowes Southway  	 thursday-2
Silverknowes Terrace  	 thursday-1
Silverknowes View  	 thursday-2
Sinclair Place  	 wednesday-1
Skerryvore Loan  	 friday-2
Slaeside  	 thursday-1
Slateford Gait  	 wednesday-1
Sleigh Drive  	 wednesday-1
Sleigh Gardens  	 wednesday-1
Sloan Street  	 thursday-1
Smeaton Gardens  	 tuesday-2
Smith's Land  	 wednesday-1
Society Road  	 tuesday-1
Somerset Place  	 thursday-2
Somerville Road  	 wednesday-1
Sommerville Gardens  	 tuesday-2
South Barnton Avenue  	 thursday-1
South Beechwood  	 wednesday-1
South Elixa Place  	 wednesday-2
South Ettrick Road  	 friday-1
South Fort Street  	 friday-1
South Gayfield Lane  	 tuesday-2
South Gillsland Road  	 friday-1
South Gray Street  	 tuesday-1
South Gyle Gardens  	 tuesday-2
South Gyle Loan  	 friday-1
South Gyle Mains  	 friday-1
South Gyle Park  	 friday-1
South Gyle Wynd  	 friday-1
South Lauder Road  	 wednesday-1
South Laverockbank Avenue  	 tuesday-1
South Learmonth Avenue  	 thursday-2
South Learmonth Gardens  	 thursday-2
South Lorne Place  	 thursday-1
South Mellis Park  	 tuesday-1
South Morton Street  	 wednesday-1
South Oswald Road  	 tuesday-2
South Oxford Street  	 thursday-1
South Park  	 tuesday-1
South Parrotshot  	 thursday-1
South Scotstoun  	 tuesday-2
South Sloan Street  	 thursday-1
South Steil  	 tuesday-1
South Trinity Road  	 wednesday-1
Southfield Bank  	 friday-2
Southfield Farm Grove  	 thursday-2
Southfield Gardens East  	 friday-2
Southfield Gardens West  	 friday-2
Southfield Loan  	 friday-2
Southfield Road East  	 friday-2
Southfield Road West  	 friday-2
Southfield Square  	 friday-2
Southfield Terrace  	 friday-2
Southfield Villas  	 wednesday-1
Southhouse Avenue  	 thursday-2
Southhouse Brae  	 thursday-2
Southhouse Broadway  	 thursday-2
Southhouse Close  	 thursday-2
Southhouse Crescent  	 thursday-2
Southhouse Crossway  	 thursday-2
Southhouse Drive  	 thursday-2
Southhouse Gardens  	 thursday-2
Southhouse Grove  	 thursday-2
Southhouse Loan  	 thursday-2
Southhouse Place  	 thursday-2
Southhouse Road  	 thursday-2
Southhouse Terrace  	 thursday-2
Southhouse Walk  	 thursday-2
Soutra Road  	 wednesday-2
Spa Place  	 friday-2
Spence Street  	 thursday-1
Spencer Place  	 tuesday-1
Spey Terrace  	 thursday-1
Spinner Lane  	 wednesday-2
Spottiswoode Road  	 wednesday-1
Spottiswoode Street  	 wednesday-1
Spring Gardens  	 thursday-1
Springfield  	 friday-1
Springfield Crescent  	 tuesday-1
Springfield Lea  	 tuesday-1
Springfield Place  	 tuesday-1
Springfield Road  	 tuesday-1
Springfield Street  	 friday-1
Springfield Terrace  	 tuesday-1
Springfield View  	 tuesday-1
Springvalley Gardens  	 wednesday-2
Springvalley Terrace  	 wednesday-2
Springwell Place  	 tuesday-1
Springwell Terrace  	 wednesday-1
Springwood Park  	 thursday-2
Spruce Way  	 wednesday-1
Spylaw Avenue  	 thursday-2
Spylaw Park  	 thursday-2
Spylaw Road  	 friday-1
Spylaw Street  	 thursday-1
St Bernard's Crescent  	 thursday-2
St Bernard's Row  	 tuesday-2
St Catherine's Gardens  	 friday-2
St Catherine's Place  	 wednesday-1
St Clair Avenue  	 thursday-1
St Clair Place  	 thursday-1
St Clair Road  	 thursday-1
St Clair Street  	 thursday-1
St Clair Terrace  	 thursday-1
St Fillan's Terrace  	 thursday-1
St Francis Way  	 tuesday-2
St John's Avenue  	 thursday-1
St John's Crescent  	 friday-2
St John's Gardens  	 thursday-1
St John's Terrace  	 thursday-1
St Katharine's Brae  	 wednesday-2
St Katharine's Crescent  	 wednesday-2
St Katharine's Loan  	 wednesday-2
St Leonard's Bank  	 wednesday-2
St Leonard's Hill  	 thursday-1
St Margaret's Place  	 wednesday-1
St Margaret's Road  	 tuesday-2
St Mark's Lane  	 friday-2
St Mark's Place  	 tuesday-1
St Martins Glebe  	 thursday-1
St Mary's Place  	 tuesday-1
St Ninian's Drive  	 friday-2
St Ninian's Road  	 friday-2
St Ninian's Terrace  	 thursday-1
St Peter's Place  	 tuesday-2
St Ronan's Terrace  	 thursday-1
St Stephen Place  	 tuesday-2
St Stephen Street  	 tuesday-2
St Teresa Place  	 friday-1
St Thomas Road  	 wednesday-1
Stair Park  	 tuesday-1
Stair Place  	 tuesday-2
Standingstane Road  	 tuesday-1
Stanedykehead  	 wednesday-2
Stanhope Place  	 wednesday-1
Stanhope Street  	 wednesday-1
Stanley Place  	 thursday-1
Stanley Road  	 tuesday-1
Stanley Street  	 wednesday-1
Stanwell Street  	 friday-1
Stapeley Avenue  	 tuesday-2
Starbank Road  	 tuesday-1
Stark's Cottages  	 tuesday-1
Station Loan  	 friday-1
Station Terrace  	 tuesday-1
Station View  	 wednesday-1
Stein Street  	 wednesday-1
Stenhouse Avenue  	 tuesday-2
Stenhouse Avenue West  	 tuesday-2
Stenhouse Cottages  	 tuesday-2
Stenhouse Crescent  	 tuesday-2
Stenhouse Drive  	 tuesday-2
Stenhouse Gardens  	 tuesday-2
Stenhouse Gardens North  	 tuesday-2
Stenhouse Grove  	 tuesday-2
Stenhouse Mill Crescent  	 wednesday-1
Stenhouse Mill Lane  	 wednesday-1
Stenhouse Place East  	 tuesday-2
Stenhouse Place West  	 tuesday-2
Stenhouse Road  	 tuesday-2
Stenhouse Street East  	 tuesday-2
Stenhouse Street West  	 tuesday-2
Stenhouse Terrace  	 tuesday-2
Stennis Gardens  	 friday-2
Stevenson Avenue  	 friday-2
Stevenson Drive  	 tuesday-2
Stevenson Grove  	 friday-2
Stevenson Road  	 friday-2
Stevenson Terrace  	 friday-2
Stewart Avenue  	 wednesday-1
Stewart Clark Avenue  	 wednesday-1
Stewart Crescent  	 wednesday-1
Stewart Gardens  	 wednesday-1
Stewart Road  	 wednesday-1
Stillhouse Loan  	 thursday-1
Stoneycroft Road  	 tuesday-1
Stoneyflatts  	 tuesday-1
Stoneyflatts Crescent  	 tuesday-1
Stoneyflatts Park  	 tuesday-1
Strachan Gardens  	 friday-1
Strachan Road  	 friday-1
Straiton Place  	 friday-2
Strathalmond Court  	 tuesday-1
Strathalmond Green  	 tuesday-1
Strathalmond Park  	 tuesday-1
Strathalmond Road  	 tuesday-1
Strathearn Place  	 tuesday-2
Strathearn Road  	 tuesday-2
Strathfillan Road  	 tuesday-2
Stuart Crescent  	 thursday-2
Stuart Green  	 thursday-2
Stuart Park  	 thursday-2
Stuart Wynd  	 thursday-2
Succoth Avenue  	 tuesday-1
Succoth Gardens  	 tuesday-1
Succoth Park  	 tuesday-1
Succoth Place  	 tuesday-1
Suffolk Road  	 tuesday-1
Suffolk Road Lane  	 tuesday-1
Summerfield Gardens  	 thursday-2
Summerfield Place  	 thursday-2
Summerside Place  	 friday-1
Summerside Street  	 friday-1
Summertrees Court  	 friday-1
Sunbury Place  	 wednesday-1
Sutherland Street  	 wednesday-1
Swan Spring Avenue  	 thursday-2
Swanston Avenue  	 tuesday-1
Swanston Crescent  	 thursday-1
Swanston Drive  	 tuesday-1
Swanston Gardens  	 tuesday-1
Swanston Green  	 thursday-1
Swanston Grove  	 tuesday-1
Swanston Loan  	 thursday-1
Swanston Muir  	 friday-1
Swanston Park  	 thursday-1
Swanston Place  	 tuesday-1
Swanston Road  	 thursday-1
Swanston Row  	 thursday-1
Swanston Terrace  	 tuesday-1
Swanston View  	 tuesday-1
Swanston Village  	 thursday-1
Swanston Way  	 thursday-1
Sycamore Gardens  	 thursday-1
Sycamore Terrace  	 thursday-1
Sydney Park  	 tuesday-2
Sydney Place  	 tuesday-2
Sydney Terrace  	 tuesday-2
Sylvan Place  	 wednesday-1
Syme Place  	 tuesday-1
Syme Rigg  	 tuesday-1
Talisman Place  	 friday-1
Talla Street  	 thursday-2
Tansy Street  	 tuesday-1
Tantallon Place  	 wednesday-1
Tarvit Street  	 wednesday-1
Tay Street  	 friday-1
Telford Drive  	 tuesday-2
Telford Gardens  	 tuesday-2
Telford Place  	 tuesday-2
Templar Crescent  	 tuesday-2
Templar's Cramond  	 wednesday-1
Temple Park Crescent  	 friday-1
Templeland Grove  	 wednesday-2
Templeland Road  	 wednesday-2
Tennant Street  	 friday-1
Teviotdale Place  	 tuesday-2
The Bowling Green  	 friday-1
The Causeway  	 friday-2
The Cedars  	 tuesday-2
The Crescent  	 thursday-1
The Gallolee  	 friday-1
The Loan  	 tuesday-1
The Murrays  	 thursday-2
The Murrays Brae  	 thursday-2
The North Walk  	 thursday-1
The Paddockholm  	 thursday-1
The Pottery  	 friday-2
The Quilts  	 friday-1
The Spinney  	 friday-1
The Square  	 thursday-1
The Steils  	 tuesday-1
The Wisp  	 tuesday-2
Thirlestane Lane  	 wednesday-2
Thirlestane Road  	 wednesday-1
Thistle Place  	 wednesday-1
Thomson Crescent  	 tuesday-1
Thomson Drive  	 tuesday-1
Thomson Grove  	 tuesday-1
Thomson Place  	 wednesday-1
Thomson Road  	 tuesday-1
Thorburn Grove  	 tuesday-2
Thorburn Road  	 tuesday-2
Thorntree Street  	 thursday-1
Thornville Terrace  	 thursday-2
Thorters Place  	 thursday-2
Threipmuir Avenue  	 thursday-1
Threipmuir Gardens  	 thursday-1
Threipmuir Place  	 thursday-1
Timmins Court  	 wednesday-2
Tipperlinn Road  	 friday-1
Tobias Street  	 tuesday-2
Toddshill Road  	 thursday-1
Todshaugh Gardens  	 thursday-1
Tor Lane  	 wednesday-2
Torduff Road  	 thursday-1
Tormain Bank  	 wednesday-2
Tormain Drive  	 wednesday-2
Torrance Park  	 thursday-2
Torrance Place  	 friday-2
Torrance Row  	 friday-2
Torrance Way  	 friday-2
Torwood Crescent  	 friday-1
Toward Court  	 friday-2
Traquair Park East  	 thursday-1
Traquair Park West  	 thursday-1
Trench Knowe  	 thursday-1
Tressilian Gardens  	 friday-1
Trinity Court  	 wednesday-1
Trinity Grove  	 tuesday-1
Trinity Mains  	 tuesday-1
Trotter Haugh  	 tuesday-2
Tryst Park  	 thursday-1
Tudsbery Avenue  	 tuesday-2
Turner Avenue  	 friday-1
Turner Park  	 friday-1
Tweedie Lane  	 friday-2
Tweedsmuir Drive  	 tuesday-2
Tweedsmuir Gait  	 tuesday-2
Tyler's Acre Avenue  	 thursday-1
Tyler's Acre Gardens  	 thursday-1
Tyler's Acre Road  	 thursday-1
Ulster Crescent  	 thursday-2
Ulster Drive  	 wednesday-2
Ulster Gardens  	 thursday-2
Ulster Grove  	 thursday-2
Ulster Terrace  	 thursday-2
Umbrella Pine Terrace  	 friday-2
Upper Coltbridge Terrace  	 wednesday-1
Upper Craigour  	 tuesday-2
Upper Craigour Way  	 tuesday-2
Upper Cramond Court  	 wednesday-1
Upper Dean Terrace  	 tuesday-2
Upper Gilmore Place  	 wednesday-1
Upper Gilmore Terrace  	 wednesday-1
Upper Gray Street  	 tuesday-1
Upper Grove Place  	 wednesday-1
Usher Mews  	 tuesday-2
Valleyfield Street  	 wednesday-1
Vanburgh Place  	 wednesday-1
Vandeleur Avenue  	 tuesday-2
Vandeleur Grove  	 tuesday-2
Vandeleur Place  	 tuesday-2
Ventnor Place  	 thursday-1
Ventnor Terrace  	 thursday-1
Venturefair Drive  	 friday-2
Vexhim Park  	 thursday-1
Victor Park Terrace  	 friday-2
Viewfield Road  	 thursday-2
Viewforth  	 tuesday-2
Viewforth Place  	 wednesday-1
Viewforth Road  	 wednesday-1
Viewforth Square  	 wednesday-1
Viewforth Terrace  	 tuesday-2
Villa Road  	 tuesday-1
Violet Terrace  	 friday-1
Vivian Terrace  	 thursday-1
Wakefield Avenue  	 tuesday-2
Walford Drive  	 tuesday-2
Walker Drive  	 tuesday-1
Walker Terrace  	 wednesday-1
Walkers Court  	 thursday-2
Walkers Rigg  	 thursday-2
Walkers Wynd  	 thursday-2
Wallace Gardens  	 wednesday-1
Wardie Avenue  	 thursday-1
Wardie Crescent  	 thursday-1
Wardie Dell  	 thursday-1
Wardie Grove  	 thursday-1
Wardie House Lane  	 wednesday-1
Wardie Park  	 thursday-1
Wardie Road  	 wednesday-1
Wardie Steps  	 wednesday-1
Wardieburn Drive  	 thursday-1
Wardieburn Place East  	 friday-2
Wardieburn Place West  	 friday-2
Wardieburn Road  	 friday-2
Wardieburn Street East  	 friday-2
Wardieburn Terrace  	 friday-2
Wardlaw Place  	 friday-2
Wardlaw Terrace  	 friday-2
Warrender Park Crescent  	 wednesday-1
Warrender Park Road  	 wednesday-1
Warrender Park Terrace  	 wednesday-1
Warriston Avenue  	 friday-1
Warriston Crescent  	 tuesday-2
Warriston Drive  	 friday-1
Warriston Gardens  	 friday-1
Warriston Grove  	 friday-1
Warriston Road  	 tuesday-2
Warriston Terrace  	 tuesday-2
Waterfield Road  	 friday-2
Watertoun Road  	 tuesday-2
Watson Crescent  	 friday-1
Watt Park  	 tuesday-2
Wauchope Crescent  	 tuesday-2
Waulkmill Loan  	 friday-1
Waverley Park  	 thursday-1
Waverley Park Terrace  	 thursday-1
Waverley Place  	 thursday-1
Weavers Knowe Crescent  	 friday-2
Wellflats Road  	 tuesday-1
Wellhead Close  	 tuesday-2
Wellington Street  	 thursday-1
West Annandale Street  	 thursday-1
West Bowling Green Street  	 friday-1
West Brighton Crescent  	 wednesday-1
West Caiystane Road  	 thursday-1
West Castle Road  	 friday-1
West Catherine Place  	 wednesday-1
West Coates  	 tuesday-1
West Craigs Avenue  	 friday-1
West Craigs Crescent  	 friday-1
West Croft  	 wednesday-2
West Fairbrae Crescent  	 thursday-2
West Fairbrae Drive  	 thursday-2
West Ferryfield  	 thursday-1
West Gorgie Place  	 friday-2
West Mains Road  	 tuesday-2
West Mayfield  	 tuesday-1
West Mill Road  	 thursday-1
West Montgomery Place  	 thursday-1
West Newington Place  	 wednesday-2
West Pilton Avenue  	 friday-2
West Pilton Bank  	 friday-2
West Pilton Brae  	 friday-2
West Pilton Drive  	 friday-2
West Pilton Gardens  	 friday-2
West Pilton Green  	 friday-2
West Pilton Grove  	 friday-2
West Pilton Lea  	 friday-2
West Pilton Loan  	 friday-2
West Pilton March  	 friday-2
West Pilton Park  	 friday-2
West Pilton Place  	 friday-2
West Pilton Rise  	 friday-2
West Pilton Road  	 friday-2
West Pilton Street  	 friday-2
West Pilton Terrace  	 friday-2
West Pilton View  	 friday-2
West Preston Street  	 thursday-1
West Relugas Road  	 tuesday-2
West Savile Gardens  	 tuesday-2
West Savile Road  	 tuesday-1
West Savile Terrace  	 tuesday-2
West Scotland Street Lane  	 tuesday-2
West Stanhope Place  	 wednesday-1
West Terrace  	 tuesday-1
West Werberside  	 tuesday-2
West Winnelstrae  	 thursday-1
West Woods  	 tuesday-2
Westbank Loan  	 tuesday-2
Westbank Place  	 tuesday-2
Westburn Avenue  	 wednesday-2
Westburn Grove  	 wednesday-2
Westburn Middlefield  	 wednesday-2
Westburn Park  	 wednesday-2
Wester Broom Avenue  	 tuesday-2
Wester Broom Drive  	 tuesday-2
Wester Broom Gardens  	 tuesday-2
Wester Broom Grove  	 tuesday-2
Wester Broom Place  	 tuesday-2
Wester Broom Terrace  	 tuesday-2
Wester Coates Avenue  	 tuesday-1
Wester Coates Gardens  	 tuesday-1
Wester Coates Place  	 wednesday-1
Wester Coates Road  	 tuesday-1
Wester Coates Terrace  	 tuesday-1
Wester Dalmeny Steading  	 wednesday-1
Wester Drylaw Avenue  	 friday-2
Wester Drylaw Drive  	 friday-2
Wester Drylaw Park  	 friday-2
Wester Drylaw Place  	 friday-2
Wester Drylaw Row  	 friday-2
Wester Hailes Road  	 thursday-2
Wester Hill  	 tuesday-1
Wester Rigg  	 friday-1
Wester Row  	 friday-1
Wester Steil  	 tuesday-1
Western Corner  	 wednesday-1
Western Gardens  	 thursday-1
Western Place  	 thursday-1
Western Terrace  	 wednesday-1
Westfield  	 tuesday-1
Westfield Road  	 friday-2
Westgarth Avenue  	 tuesday-2
Westhall Gardens  	 wednesday-1
Wheatlands  	 tuesday-1
Whins Place  	 friday-2
Whinstone Place  	 wednesday-2
White Dales  	 tuesday-1
Whiteadder Loan  	 thursday-2
Whitehead Grove  	 wednesday-1
Whitehill Street  	 thursday-1
Whitehouse Loan  	 tuesday-2
Whitehouse Terrace  	 tuesday-2
Whitelea Crescent  	 thursday-1
Whitelea Road  	 thursday-1
Whitingford  	 friday-1
Whitson Crescent  	 tuesday-2
Whitson Grove  	 tuesday-2
Whitson Place East  	 tuesday-2
Whitson Place West  	 tuesday-2
Whitson Road  	 tuesday-2
Whitson Terrace  	 tuesday-2
Whitson Walk  	 tuesday-2
Whitson Way  	 tuesday-2
Wilfrid Terrace  	 thursday-2
Wilkieston Road  	 wednesday-2
Wilkinson Drive  	 wednesday-2
William Black Place  	 wednesday-1
William Jameson Place  	 friday-2
Willow Tree Place  	 wednesday-1
Willowbrae Avenue  	 wednesday-2
Willowbrae Gardens  	 wednesday-2
Wilton Road  	 tuesday-1
Windrush Drive  	 tuesday-1
Windsor Place  	 friday-2
Winton Drive  	 tuesday-1
Winton Gardens  	 tuesday-1
Winton Grove  	 tuesday-1
Winton Loan  	 tuesday-1
Winton Park  	 tuesday-1
Winton Terrace  	 tuesday-1
Wintour Lane  	 tuesday-1
Wisp Green  	 tuesday-2
Wolrige Road  	 thursday-2
Wolseley Crescent  	 thursday-2
Wolseley Gardens  	 thursday-2
Woodbine Terrace  	 thursday-2
Woodburn Terrace  	 wednesday-2
Woodcroft Road  	 wednesday-2
Woodhall Avenue  	 tuesday-1
Woodhall Drive  	 tuesday-1
Woodhall Millbrae  	 tuesday-1
Woodhall Terrace  	 tuesday-1
Woodlands Grove  	 thursday-2
Woodside Terrace  	 tuesday-1
Woodstock Place  	 friday-1
Woodville Terrace  	 thursday-2
Wyvern Park  	 wednesday-1
Yeaman Place  	 friday-1
Yewlands Crescent  	 thursday-2
Yewlands Gardens  	 thursday-2
York Place  	 thursday-1
York Road  	 tuesday-1
Yorkston Court  	 friday-1
Young Drive  	 wednesday-1
Zetland Place  	 wednesday-1