abbey street	None	 thursday-1
abbotsford court	None	 friday-1
abbotsford crescent	 tuesday-2	 tuesday-2
abbotsford park	 tuesday-2	 tuesday-2
abercorn avenue	 wednesday-2	 wednesday-2
abercorn crescent	 wednesday-2	 wednesday-2
abercorn drive	 wednesday-2	 wednesday-2
abercorn gardens	 wednesday-2	 tuesday-1
abercorn grove	 wednesday-2	 wednesday-2
abercorn road	 wednesday-2	 wednesday-2
abercorn terrace	 friday-2	 tuesday-1
abercromby place	 wednesday-1	 tuesday-2
abinger gardens	 friday-1	 wednesday-1
achnacarry street	 thursday-2	 wednesday-2
adams well	 wednesday-2	 friday-1
adamslaw place	None	 tuesday-2
addiston crescent	 wednesday-1	 friday-1
addiston farm road	 thursday-1	 tuesday-1
addiston grove	 wednesday-1	 friday-1
addiston park	 wednesday-1	 friday-1
adelphi grove	 friday-1	 friday-2
adelphi place	 friday-1	 friday-2
adit place	 thursday-1	 thursday-2
admiral terrace	 tuesday-2	 wednesday-1
affleck court	 thursday-2	 friday-2
afton place	 tuesday-2	 wednesday-1
afton terrace	 tuesday-2	 wednesday-1
ainslie place	 wednesday-1	 wednesday-1
aitchison's place	 friday-1	 friday-2
alan breck gardens	 friday-1	 thursday-2
albany street	 wednesday-1	 tuesday-2
albert terrace	 tuesday-2	 friday-1
albion place	None	 thursday-1
albion road	None	 thursday-1
albion terrace	None	 thursday-1
alcorn square	 wednesday-1	 wednesday-2
alderbank gardens	 tuesday-1	 wednesday-1
alderbank place	 tuesday-1	 wednesday-1
alderbank terrace	 tuesday-1	 wednesday-1
alemoor crescent	 wednesday-1	 wednesday-1
alemoor park	 wednesday-1	 wednesday-1
alexander drive	 tuesday-2	 friday-2
alfred place	 wednesday-1	 thursday-1
allan park	 thursday-1	 thursday-1
allan park crescent	 tuesday-2	 wednesday-1
allan park drive	 tuesday-2	 wednesday-1
allan park gardens	 tuesday-2	 wednesday-1
allan park loan	 tuesday-2	 wednesday-1
allan park road	 tuesday-2	 wednesday-1
allison place	 thursday-1	 tuesday-2
alloway loan	None	 wednesday-2
almond bank cottages	 friday-1	 wednesday-1
almond green	 thursday-2	 friday-2
almond grove	 thursday-1	 wednesday-1
almond square	 thursday-2	 friday-2
almondbank terrace	 tuesday-1	 wednesday-1
almondhill	 thursday-1	 tuesday-2
almondhill road	 thursday-1	 tuesday-2
almondhill steading	 thursday-1	 tuesday-2
almondside	 thursday-1	 thursday-1
alnwickhill court	 thursday-2	 wednesday-2
alnwickhill crescent	 thursday-2	 wednesday-2
alnwickhill drive	 thursday-2	 wednesday-2
alnwickhill gardens	 thursday-2	 wednesday-2
alnwickhill grove	 thursday-2	 wednesday-2
alnwickhill loan	 thursday-2	 wednesday-2
alnwickhill park	 thursday-2	 wednesday-2
alnwickhill terrace	 thursday-2	 wednesday-2
alnwickhill view	 thursday-2	 wednesday-2
alva place	None	 thursday-1
andrew balfour grove	 wednesday-1a	 thursday-1
angle park terrace	 tuesday-2	 friday-1
ann street	 tuesday-1	 tuesday-2
annandale street	 wednesday-1	 thursday-1
annfield street	 wednesday-1	 tuesday-1
appin terrace	None	 wednesday-1
arboretum place	 tuesday-2	 friday-1
arboretum road	 tuesday-2	 friday-1
arden street	None	 wednesday-1
ardmillan place	 tuesday-1	 friday-1
ardmillan terrace	 tuesday-2	 friday-1
ardshiel avenue	 friday-1	 thursday-2
argyle crescent	 friday-2	 tuesday-1
argyle park terrace	 tuesday-1	 wednesday-1
argyle place	 tuesday-2	 wednesday-1
argyll terrace	 tuesday-1	 wednesday-1
arkaig gardens	 thursday-2	 wednesday-2
armstrong road	None	 wednesday-2
arnott gardens	 tuesday-2	 thursday-2
arrol place	 thursday-1	 wednesday-1
ashburnham gardens	 thursday-1	 wednesday-1
ashburnham loan	 thursday-1	 wednesday-1
ashburnham road	 thursday-1	 wednesday-1
ashley drive	 tuesday-2	 friday-1
ashley gardens	 tuesday-2	 friday-1
ashley grange	 wednesday-1	 friday-1
ashley grove	 tuesday-2	 friday-1
ashley place	None	 friday-1
ashley terrace	 tuesday-2	 friday-1
ashton grove	 friday-1	 wednesday-2
ashton villas	 friday-2	 wednesday-1
ashville terrace	 wednesday-1	 thursday-2
ashwood gait	 friday-1	 thursday-2
atheling grove	 thursday-1	 tuesday-2
atholl terrace	 tuesday-1	 wednesday-1
auchingane	 wednesday-2	 friday-1
auchinleck's brae	 wednesday-1	 tuesday-1
auldgate	 thursday-1	 tuesday-1
avenel	 friday-1	 wednesday-1
avenue villas	 tuesday-2	 wednesday-2
avon grove	 friday-1	 wednesday-1
avon place	 friday-1	 wednesday-1
avon road	 friday-1	 wednesday-1
avondale place	 tuesday-1	 tuesday-2
baberton avenue	 wednesday-1	 tuesday-1
baberton crescent	 wednesday-1	 tuesday-1
baberton loan	 wednesday-1	 friday-1
baberton mains avenue	 wednesday-1	 wednesday-2
baberton mains bank	 wednesday-1	 wednesday-2
baberton mains brae	 wednesday-1	 wednesday-2
baberton mains court	 wednesday-1	 wednesday-2
baberton mains crescent	 wednesday-1	 wednesday-2
baberton mains dell	 wednesday-1	 wednesday-2
baberton mains drive	 wednesday-1	 wednesday-2
baberton mains gardens	 wednesday-1	 wednesday-2
baberton mains green	 wednesday-1	 wednesday-2
baberton mains grove	 wednesday-1	 wednesday-2
baberton mains hill	 wednesday-1	 wednesday-2
baberton mains lea	 wednesday-1	 wednesday-2
baberton mains loan	 wednesday-1	 wednesday-2
baberton mains park	 wednesday-1	 wednesday-2
baberton mains place	 wednesday-1	 wednesday-2
baberton mains rise	 wednesday-1	 wednesday-2
baberton mains row	 wednesday-1	 wednesday-2
baberton mains terrace	 wednesday-1	 wednesday-2
baberton mains view	 wednesday-1	 wednesday-2
baberton mains way	 wednesday-1	 wednesday-2
baberton mains wood	 wednesday-1	 wednesday-2
baberton mains wynd	 wednesday-1	 wednesday-2
baberton park	 wednesday-1	 tuesday-1
baberton square	 wednesday-1	 tuesday-1
back dean	 friday-1	 wednesday-1
backlee	 thursday-2	 wednesday-2
badger neuk	 wednesday-1	 thursday-2
badger way	 wednesday-1	 thursday-2
baileyfield road	 friday-2	 tuesday-2
bailie grove	 friday-2	 wednesday-1
bailie path	 friday-2	 thursday-1
bailie place	 friday-2	 wednesday-1
bailie terrace	 friday-2	 wednesday-1
bain rigg	None	 thursday-2
bain street	None	 thursday-2
baird avenue	 friday-2	 wednesday-1
baird drive	 friday-2	 wednesday-1
baird gardens	 friday-2	 wednesday-1
baird grove	 friday-2	 wednesday-1
baird road	 thursday-1	 wednesday-2
baird terrace	 friday-2	 wednesday-1
balbirnie place	 tuesday-2	 wednesday-1
balcarres street	 tuesday-1	 thursday-1
balcomie gardens	 thursday-1	 tuesday-2
balderston gardens	 friday-1	 friday-1
balderston gardens north	 friday-1	 friday-1
balfour place	None	 friday-1
balfour street	 wednesday-1	 friday-1
balfron loan	 friday-1	 thursday-2
balgreen avenue	 friday-2	 wednesday-1
balgreen gardens	 friday-2	 wednesday-1
balgreen park	 friday-2	 wednesday-1
ballantyne lane	None	 friday-1
ballantyne place	 wednesday-1	 friday-1
balmoral place	 tuesday-1	 tuesday-2
balmwell avenue	 thursday-2	 wednesday-2
balmwell grove	 thursday-2	 wednesday-2
balmwell park	 thursday-2	 wednesday-2
balmwell terrace	 thursday-2	 wednesday-2
balneil place	 thursday-1	 tuesday-2
bangholm avenue	 tuesday-2	 tuesday-1
bangholm bower avenue	 tuesday-2	 wednesday-1
bangholm grove	 tuesday-2	 tuesday-1
bangholm loan	 tuesday-2	 tuesday-1
bangholm park	 tuesday-2	 tuesday-1
bangholm road	 tuesday-2	 tuesday-1
bangholm terrace	 tuesday-1	 friday-1
bangholm view	 tuesday-2	 tuesday-1
bangholm villas	 tuesday-2	 tuesday-1
bangor road	 wednesday-1	 friday-1
bankhead grove	 thursday-1	 wednesday-1
bankhead road	 thursday-1	 tuesday-1
bannerman cruick	None	 friday-2
bannerman terrace	None	 friday-2
barn park	None	 wednesday-2
barn park crescent	 wednesday-2	 wednesday-2
barnie terrace	None	 tuesday-2
barnshot road	 wednesday-2	 tuesday-2
barntalloch court	 thursday-2	 friday-2
barnton avenue	 friday-1	 thursday-1
barnton avenue west	 friday-1	 wednesday-1
barnton brae	 friday-1	 wednesday-1
barnton gardens	 friday-1	 thursday-1
barnton grove	 thursday-2	 tuesday-1
barnton loan	 friday-1	 tuesday-1
barnton park	 friday-1	 thursday-1
barnton park avenue	 thursday-2	 tuesday-1
barnton park crescent	 thursday-2	 tuesday-1
barnton park dell	 thursday-2	 tuesday-1
barnton park drive	 thursday-2	 tuesday-1
barnton park gardens	 thursday-2	 tuesday-1
barnton park grove	 thursday-2	 tuesday-1
barnton park place	 thursday-2	 tuesday-1
barnton park view	 thursday-2	 tuesday-1
barnton park wood	 thursday-2	 tuesday-1
barntongate avenue	 thursday-2	 tuesday-2
barntongate drive	 thursday-2	 tuesday-2
barntongate terrace	 thursday-2	 tuesday-2
barnyard park crescent	 thursday-2	 friday-1
barnyard park loan	 thursday-2	 friday-1
barnyard park rigg	 thursday-2	 friday-1
baronscourt road	 wednesday-2	 wednesday-2
baronscourt terrace	 wednesday-2	 wednesday-2
barony street	 wednesday-1	 tuesday-2
barony terrace	 friday-1	 friday-2
bath place	 friday-1	 friday-2
bath street	 friday-2	 friday-2
bathfield	 wednesday-1	 friday-1
bauld drive	 wednesday-1a	 thursday-1
bavelaw gardens	 wednesday-1	 thursday-1
bavelaw green	 wednesday-1	 thursday-1
beach lane	 friday-2	 friday-2
beauchamp grove	 thursday-2	 thursday-2
beauchamp road	 thursday-2	 thursday-2
beaufort road	 tuesday-2	 wednesday-1
bedford terrace	 friday-2	 tuesday-1
beechmount crescent	 friday-2	 wednesday-1
beechmount park	 friday-2	 wednesday-1
beechwood mains	 friday-1	 thursday-1
beechwood terrace	 wednesday-1	 thursday-2
belford avenue	 friday-2	 thursday-2
belford gardens	 friday-2	 thursday-2
belford park	 tuesday-2	 tuesday-1
belford place	 tuesday-1	 wednesday-1
belford terrace	 tuesday-2	 wednesday-1
belgrave crescent	 tuesday-1	 thursday-2
belgrave crescent lane	 tuesday-1	 thursday-2
belgrave gardens	 friday-1	 friday-2
belgrave place	 tuesday-1	 thursday-2
belgrave road	 friday-1	 friday-2
belgrave terrace	 friday-1	 friday-2
belhaven terrace	None	 thursday-1
bell place	 tuesday-1	 tuesday-2
bellevue crescent	 wednesday-1	 tuesday-2
bellevue gardens	 wednesday-1	 thursday-1
bellevue grove	 wednesday-1	 thursday-1
bellevue place	 wednesday-1	 thursday-1
bellevue road	 wednesday-1	 thursday-1
bellevue street	 wednesday-1	 thursday-1
bellevue terrace	 wednesday-1	 tuesday-2
bellfield lane	 friday-1	 friday-2
bellfield street	 friday-2	 friday-2
bellfield terrace	 friday-1	 friday-2
bellrock park	 tuesday-1	 friday-2
belmont avenue	 friday-2	 wednesday-1
belmont crescent	 friday-2	 wednesday-1
belmont drive	 friday-2	 wednesday-1
belmont gardens	 friday-2	 wednesday-1
belmont park	 friday-2	 wednesday-1
belmont road	 wednesday-1	 tuesday-1
belmont terrace	 friday-1	 thursday-1
belmont view	 friday-2	 wednesday-1
benhar road	 wednesday-1a	 thursday-1
beresford avenue	 tuesday-2	 tuesday-1
beresford gardens	 tuesday-2	 tuesday-1
beresford place	 tuesday-2	 tuesday-1
beresford terrace	 tuesday-2	 tuesday-1
bethlehem way	None	 wednesday-1
biggar road	 tuesday-1	 tuesday-1
bill douglas grove	 wednesday-1a	 thursday-1
bingham avenue	 friday-2	 friday-2
bingham broadway	 friday-2	 friday-2
bingham crescent	 friday-2	 friday-2
bingham crossway	 friday-2	 friday-2
bingham drive	 friday-2	 friday-2
bingham medway	 friday-2	 friday-2
bingham place	 friday-2	 friday-2
bingham way	 friday-2	 friday-2
blackadder drive	 wednesday-1	 wednesday-1
blackbarony road	 thursday-2	 wednesday-2
blackburn crag	 thursday-1	 friday-1
blackchapel close	 wednesday-1a	 thursday-1
blackchapel road	 wednesday-1a	 thursday-1
blacket avenue	 wednesday-1	 thursday-1
blacket place	 wednesday-1	 thursday-1
blackford avenue	 tuesday-2	 tuesday-2
blackford bank	 tuesday-2	 tuesday-2
blackford glen road	 thursday-2	 wednesday-2
blackford hill grove	 tuesday-2	 tuesday-2
blackford hill rise	 tuesday-2	 tuesday-2
blackford hill view	 tuesday-2	 tuesday-2
blackford road	 tuesday-2	 wednesday-1
blackie road	 wednesday-1	 wednesday-1
blackthorn court	 thursday-2	 tuesday-2
blackwood crescent	None	 wednesday-2
blaeberry gardens	 thursday-2	 tuesday-2
blantyre terrace	 tuesday-1	 tuesday-2
bleachfield	 wednesday-1	 friday-1
blenheim place	 wednesday-1	 thursday-1
blinkbonny avenue	 friday-2	 thursday-2
blinkbonny crescent	 friday-2	 wednesday-2
blinkbonny gardens	 friday-2	 thursday-2
blinkbonny grove	 friday-2	 wednesday-2
blinkbonny grove west	 friday-2	 wednesday-2
blinkbonny terrace	 friday-2	 wednesday-2
bluebell terrace	 friday-1	 tuesday-2
bogsmill road	 wednesday-1	 thursday-1
bonaly avenue	 wednesday-2	 tuesday-2
bonaly brae	 wednesday-2	 tuesday-2
bonaly crescent	 wednesday-2	 tuesday-2
bonaly drive	 wednesday-2	 tuesday-2
bonaly gardens	 wednesday-2	 tuesday-2
bonaly grove	 wednesday-2	 tuesday-2
bonaly rise	 wednesday-2	 tuesday-2
bonaly steading	 wednesday-2	 tuesday-2
bonaly terrace	 wednesday-2	 tuesday-2
bonaly wester	 wednesday-2	 tuesday-2
bonnington	 thursday-1	 tuesday-1
bonnington avenue	 wednesday-1	 friday-1
bonnington grove	 tuesday-1	 thursday-2
bonnington terrace	 wednesday-1	 friday-1
bonnybridge drive	 friday-1	 thursday-1
bonnyhaugh lane	 wednesday-1	 friday-1
boothacre cottages	 wednesday-1	 wednesday-1
boothacre lane	 wednesday-1	 wednesday-1
borrowman square	 thursday-1	 tuesday-2
borthwick place	 tuesday-1	 wednesday-1
boswall avenue	 tuesday-2	 thursday-1
boswall crescent	 tuesday-2	 thursday-1
boswall drive	 tuesday-2	 thursday-1
boswall gardens	 tuesday-2	 thursday-1
boswall green	 tuesday-2	 thursday-1
boswall grove	 tuesday-2	 thursday-1
boswall loan	 tuesday-2	 thursday-1
boswall parkway	None	 friday-2
boswall place	 tuesday-2	 thursday-1
boswall quadrant	 tuesday-2	 thursday-1
boswall road	 tuesday-2	 wednesday-1
boswall square	 tuesday-2	 thursday-1
boswall terrace	 tuesday-2	 thursday-1
bowbridge crescent	 thursday-2	 wednesday-2
bowes place	 friday-1	 tuesday-2
bowling green road	 thursday-1	 thursday-1
brae park	 friday-1	 tuesday-1
brae park road	 friday-1	 tuesday-1
braeburn drive	 wednesday-1	 friday-1
braefoot terrace	 thursday-2	 wednesday-2
braehead avenue	 friday-1	 tuesday-1
braehead bank	 friday-1	 tuesday-1
braehead crescent	 friday-1	 tuesday-1
braehead drive	 friday-1	 tuesday-1
braehead grove	 friday-1	 tuesday-1
braehead loan	 friday-1	 tuesday-1
braehead park	 friday-1	 tuesday-1
braehead road	 friday-1	 tuesday-1
braehead row	 friday-1	 tuesday-1
braehead view	 friday-1	 tuesday-1
braid avenue	None	 wednesday-2
braid crescent	 tuesday-1	 wednesday-2
braid farm road	 tuesday-1	 wednesday-2
braid hills approach	 tuesday-1	 thursday-2
braid hills avenue	 tuesday-1	 wednesday-2
braid hills crescent	 tuesday-1	 wednesday-2
braid hills road	 tuesday-1	 wednesday-2
braid mount	 tuesday-1	 thursday-2
braid mount crest	 tuesday-1	 thursday-2
braid mount rise	 tuesday-1	 thursday-2
braid mount view	 tuesday-1	 thursday-2
braidburn crescent	 tuesday-1	 wednesday-2
braidburn terrace	 tuesday-1	 wednesday-2
bramble drive	 thursday-2	 tuesday-2
bramdean grove	 tuesday-1	 thursday-2
bramdean place	 tuesday-1	 thursday-2
bramdean rise	 tuesday-1	 thursday-2
bramdean view	 tuesday-1	 thursday-2
brand drive	 friday-2	 wednesday-1
brand gardens	 friday-2	 wednesday-1
branders place	 thursday-1	 tuesday-2
brandon terrace	None	 friday-1
breadalbane terrace	 tuesday-1	 wednesday-1
briarbank terrace	 tuesday-1	 wednesday-1
brickfield	 friday-1	 friday-2
bridge end	 friday-1	 thursday-1
bridge place	 tuesday-1	 tuesday-2
bridge street	None	 wednesday-2
briery bauks	 friday-1	 wednesday-2
briggers brae	 thursday-1	 wednesday-1
briggers wynd	 thursday-1	 wednesday-1
brighouse park court	 friday-1	 wednesday-1
brighouse park crescent	 friday-1	 wednesday-1
brighouse park cross	 friday-1	 wednesday-1
brighouse park drive	 friday-1	 wednesday-1
brighouse park gait	 friday-1	 wednesday-1
brighouse park gardens	 friday-1	 wednesday-1
brighouse park rigg	 friday-1	 wednesday-1
bright terrace	 tuesday-1	 wednesday-1
bright's crescent	 tuesday-2	 wednesday-2
brighton place	 friday-2	 wednesday-1
brighton street	None	 thursday-1
britwell crescent	 wednesday-2	 tuesday-1
brock view	 wednesday-1	 friday-2
brocken brigg road	 wednesday-1	 friday-2
broombank terrace	 friday-1	 tuesday-2
broomburn grove	 friday-1	 tuesday-2
broomfield crescent	 friday-1	 thursday-1
broomhall avenue	 friday-1	 tuesday-2
broomhall bank	 friday-1	 tuesday-2
broomhall crescent	 friday-1	 tuesday-2
broomhall drive	None	 tuesday-2
broomhall gardens	 friday-1	 tuesday-2
broomhall loan	 friday-1	 tuesday-2
broomhall park	 friday-1	 tuesday-2
broomhall place	 friday-1	 tuesday-2
broomhall road	 friday-1	 tuesday-2
broomhall terrace	 friday-1	 tuesday-2
broomhouse avenue	 thursday-2	 thursday-2
broomhouse bank	 thursday-2	 thursday-2
broomhouse cottages	 thursday-2	 thursday-2
broomhouse cottages west	 thursday-2	 thursday-2
broomhouse court	 thursday-2	 thursday-2
broomhouse crescent	 thursday-2	 thursday-2
broomhouse drive	 thursday-2	 thursday-2
broomhouse gardens	 thursday-2	 thursday-2
broomhouse gardens east	 thursday-2	 thursday-2
broomhouse gardens west	 thursday-2	 thursday-2
broomhouse grove	 thursday-2	 thursday-2
broomhouse loan	 thursday-2	 thursday-2
broomhouse market	 thursday-2	 thursday-2
broomhouse medway	 thursday-2	 thursday-2
broomhouse park	 thursday-2	 thursday-2
broomhouse path	 thursday-2	 thursday-2
broomhouse place north	 thursday-2	 thursday-2
broomhouse place south	 thursday-2	 thursday-2
broomhouse row	 thursday-2	 thursday-2
broomhouse square	 thursday-2	 thursday-2
broomhouse street north	 thursday-2	 thursday-2
broomhouse street south	 thursday-2	 thursday-2
broomhouse terrace	 thursday-2	 thursday-2
broomhouse walk	 thursday-2	 thursday-2
broomhouse way	 thursday-2	 thursday-2
broomlea crescent	 friday-1	 tuesday-2
broompark road	 friday-1	 tuesday-2
broomside terrace	 friday-1	 thursday-1
broomyknowe	 tuesday-2	 wednesday-1
brosie road	 wednesday-1	 friday-2
brougham place	None	 wednesday-1
brougham street	None	 wednesday-1
broughton place	 wednesday-1	 tuesday-2
broughton place lane	 wednesday-1	 tuesday-2
broughton road	 wednesday-1	 friday-1
bruce street	None	 thursday-1
brunstane bank	 friday-2	 tuesday-1
brunstane crescent	 friday-2	 tuesday-1
brunstane drive	 friday-2	 wednesday-1
brunstane gardens	 friday-1a	 friday-2
brunstane gardens mews	 friday-2	 friday-2
brunstane mill road	 friday-2	 tuesday-1
brunstane road north	 friday-2	 tuesday-1
brunstane road south	 friday-2	 wednesday-1
brunswick road	None	 thursday-1
brunswick street	None	 thursday-1
brunswick terrace	 wednesday-2	 thursday-1
brunton gardens	None	 thursday-1
brunton place	None	 thursday-1
brunton terrace	None	 thursday-1
bruntsfield avenue	 tuesday-1	 tuesday-2
bruntsfield crescent	 tuesday-2	 tuesday-2
bruntsfield gardens	None	 tuesday-2
bruntsfield place	 tuesday-2	 tuesday-2
bruntsfield terrace	 tuesday-2	 tuesday-2
bryce avenue	 wednesday-2	 tuesday-2
bryce crescent	 wednesday-1	 tuesday-1
bryce place	 wednesday-1	 tuesday-1
bryce road	 wednesday-1	 tuesday-1
bryson road	None	 friday-1
buccleuch street	None	 thursday-1
buchanan street	None	 thursday-1
buckingham terrace	 tuesday-1	 thursday-2
buckstane park	 tuesday-1	 thursday-2
buckstone avenue	 tuesday-1	 friday-2
buckstone bank	 tuesday-1	 friday-2
buckstone circle	 tuesday-1	 friday-2
buckstone close	 tuesday-1	 friday-2
buckstone court	 tuesday-1	 friday-2
buckstone crescent	 tuesday-1	 friday-2
buckstone crook	 tuesday-1	 friday-2
buckstone dell	 tuesday-1	 friday-2
buckstone drive	 tuesday-1	 friday-2
buckstone gardens	 tuesday-1	 friday-2
buckstone gate	 tuesday-1	 friday-2
buckstone green	 tuesday-1	 friday-2
buckstone grove	 tuesday-1	 friday-2
buckstone hill	 tuesday-1	 friday-2
buckstone howe	 tuesday-1	 friday-2
buckstone lea	 tuesday-1	 friday-2
buckstone loan	 tuesday-1	 friday-2
buckstone loan east	 tuesday-1	 friday-2
buckstone neuk	 tuesday-1	 friday-2
buckstone place	 tuesday-1	 friday-2
buckstone rise	 tuesday-1	 friday-2
buckstone road	 tuesday-1	 friday-2
buckstone row	 tuesday-1	 friday-2
buckstone shaw	 tuesday-1	 friday-2
buckstone terrace	 tuesday-1	 thursday-2
buckstone view	 tuesday-1	 friday-2
buckstone way	 tuesday-1	 friday-2
buckstone wood	 tuesday-1	 friday-2
buckstone wynd	 tuesday-1	 friday-2
bughtlin drive	 thursday-2	 friday-2
bughtlin gardens	 thursday-2	 friday-2
bughtlin green	 thursday-2	 friday-2
bughtlin loan	 thursday-2	 friday-2
bughtlin market	 thursday-2	 friday-2
bughtlin park	 thursday-2	 friday-2
bughtlin place	 thursday-2	 friday-2
buie brae	 thursday-1	 thursday-1
buie haugh	 thursday-1	 thursday-1
buie rigg	 thursday-1	 thursday-1
bullfinch row	 wednesday-1	 thursday-2
bullfinch way	 wednesday-1	 thursday-2
burdiehouse avenue	 thursday-1	 thursday-2
burdiehouse crossway	 thursday-1	 thursday-2
burdiehouse drive	 thursday-1	 thursday-2
burdiehouse loan	 thursday-1	 thursday-2
burdiehouse medway	 thursday-1	 thursday-2
burdiehouse place	 thursday-1	 thursday-2
burdiehouse road	 thursday-1	 wednesday-2
burdiehouse square	 thursday-1	 thursday-2
burdiehouse street	 thursday-1	 thursday-2
burdiehouse terrace	 thursday-1	 thursday-2
burgess road	 thursday-1	 wednesday-1
burgess terrace	 wednesday-1	 thursday-1
burghtoft	 thursday-1	 friday-2
burnbrae	 thursday-2	 friday-2
burnbrae avenue	 thursday-2	 friday-2
burnbrae drive	 thursday-2	 friday-2
burnbrae grove	 thursday-2	 friday-2
burnbrae place	 thursday-2	 friday-2
burndale place	 thursday-1	 friday-2
burnhead crescent	 thursday-2	 wednesday-2
burnhead grove	 thursday-2	 wednesday-2
burnhead loan	 thursday-2	 wednesday-2
burnhead path east	 thursday-2	 wednesday-2
burnhead path west	 thursday-2	 wednesday-2
burns street	 wednesday-1	 thursday-2
burnside	 thursday-2	 friday-2
burnside park	 wednesday-1	 thursday-1
burton place	 wednesday-1	 friday-1
buteland road	 wednesday-1	 friday-1
butlaw	 thursday-1	 tuesday-1
byrehope way	 wednesday-2	 tuesday-2
caddell's row	 friday-1	 wednesday-1
cadogan road	 thursday-2	 thursday-2
caerlaverock court	 thursday-2	 friday-2
cairnmuir road	 friday-1	 friday-2
cairns drive	 wednesday-1	 thursday-1
cairns gardens	 wednesday-1	 thursday-1
caithness place	 tuesday-2	 tuesday-1
caiyside	 tuesday-1	 thursday-1
caiystane avenue	 tuesday-1	 thursday-1
caiystane crescent	 tuesday-1	 thursday-1
caiystane drive	 tuesday-1	 thursday-1
caiystane gardens	 tuesday-1	 thursday-1
caiystane hill	 tuesday-1	 thursday-1
caiystane terrace	 tuesday-1	 thursday-1
caiystane view	 tuesday-1	 thursday-1
cakemuir gardens	 friday-1	 tuesday-2
calder court	 wednesday-2	 thursday-2
calder crescent	 wednesday-2	 thursday-2
calder drive	 wednesday-2	 thursday-2
calder gardens	 wednesday-2	 thursday-2
calder grove	 wednesday-2	 thursday-2
calder road gardens	 wednesday-2	 tuesday-2
calder view	 wednesday-1	 thursday-2
caledonian crescent	None	 tuesday-1
caledonian place	None	 tuesday-1
caledonian road	None	 tuesday-1
cambridge avenue	 wednesday-1	 friday-1
cambridge gardens	 wednesday-1	 friday-1
cambusnethan street	None	 thursday-1
cameron crescent	 friday-1	 thursday-1
cameron house avenue	 friday-1	 thursday-1
cameron march	 thursday-2	 tuesday-1
cameron park	 friday-1	 wednesday-2
cameron terrace	 friday-1	 thursday-1
cameron toll gardens	 friday-1	 thursday-1
cammo bank	 thursday-2	 tuesday-1
cammo brae	 thursday-2	 tuesday-1
cammo crescent	 thursday-2	 tuesday-1
cammo gardens	 thursday-2	 tuesday-1
cammo grove	 thursday-2	 tuesday-1
cammo hill	 thursday-2	 tuesday-1
cammo parkway	 thursday-2	 tuesday-1
cammo place	 thursday-2	 tuesday-1
cammo road	 thursday-2	 tuesday-1
cammo walk	 thursday-2	 tuesday-1
campbell avenue	 friday-2	 tuesday-1
campbell road	 friday-2	 tuesday-1
camus avenue	 tuesday-1	 thursday-2
camus park	 tuesday-1	 thursday-2
camus road east	 tuesday-1	 thursday-2
camus road west	 tuesday-1	 thursday-2
canaan lane	 tuesday-1	 wednesday-2
canalside	 thursday-1	 wednesday-2
candlemaker's crescent	 thursday-1	 friday-1
candlemaker's park	 thursday-1	 friday-1
canmore street	 thursday-1	 wednesday-1
cannon wynd	None	 friday-1
canon street	 wednesday-1	 tuesday-2
capella gardens	 friday-1	 tuesday-2
captain's drive	None	 wednesday-2
captain's loan	 thursday-2	 wednesday-2
captain's road	 thursday-1	 wednesday-2
captain's row	 thursday-1	 wednesday-2
carberry place	 tuesday-1	 wednesday-1
carfrae gardens	 friday-2	 friday-1
carfrae grove	 friday-2	 friday-1
carfrae park	 friday-2	 friday-1
carfrae road	 friday-2	 friday-1
cargil court	 tuesday-2	 wednesday-1
cargil terrace	 tuesday-2	 wednesday-1
cargilfield view	 friday-1	 wednesday-1
carlow gardens	 thursday-1	 tuesday-2
carlowrie avenue	 thursday-1	 tuesday-1
carlowrie crescent	 thursday-1	 tuesday-1
carlton street	 monday	 thursday-2
carlton terrace	 wednesday-1	 thursday-1
carlyle place	None	 thursday-1
carmel avenue	 thursday-1	 thursday-1
carmel road	 thursday-1	 thursday-1
carmelite road	 thursday-1	 wednesday-1
carnbee avenue	 thursday-2	 thursday-2
carnbee crescent	 thursday-2	 thursday-2
carnbee dell	 thursday-2	 thursday-2
carnbee end	 thursday-2	 thursday-2
carnbee park	 thursday-2	 thursday-2
carnethy avenue	 wednesday-2	 tuesday-2
caroline gardens	 friday-1	 wednesday-2
caroline park	 tuesday-1	 tuesday-2
caroline place	 friday-1	 wednesday-2
caroline terrace	 friday-1	 wednesday-2
carrick knowe avenue	 friday-1	 thursday-1
carrick knowe drive	 friday-1	 thursday-1
carrick knowe gardens	 friday-1	 thursday-1
carrick knowe grove	 friday-1	 thursday-1
carrick knowe hill	 friday-1	 thursday-1
carrick knowe loan	 friday-1	 thursday-1
carrick knowe parkway	 friday-1	 thursday-1
carrick knowe place	 friday-1	 thursday-1
carrick knowe road	 friday-1	 thursday-1
carrick knowe terrace	 friday-1	 thursday-1
carrie grove	 thursday-1	 tuesday-2
carter drive	 wednesday-1	 friday-2
cassidy wynd	 wednesday-1	 friday-1
castle avenue	 friday-1	 tuesday-2
castle gogar rigg	 thursday-1	 tuesday-1
castlebrae glebe	 friday-1	 tuesday-2
castlebrae grove	 friday-1	 tuesday-2
castlebrae place	 friday-1	 tuesday-2
castlebrae rigg	 friday-1	 tuesday-2
castlebrae wynd	 friday-1	 tuesday-2
castlelaw road	 wednesday-2	 tuesday-2
castlepark gait	 friday-1	 tuesday-2
castlepark green	 friday-1	 tuesday-2
castleview avenue	 friday-1	 tuesday-2
castleview grove	 friday-1	 tuesday-2
castleview terrace	 friday-1	 tuesday-2
catchilraw drive	 thursday-2	 wednesday-2
catelbock close	 thursday-1	 tuesday-2
cathcart place	None	 tuesday-1
catstane road	 thursday-1	 tuesday-2
caulderhame road	 wednesday-1	 friday-2
causewayside	 tuesday-2	 tuesday-1
cavalry park drive	 friday-2	 thursday-2
chalmers crescent	 tuesday-2	 wednesday-1
chamberlain road	 tuesday-2	 tuesday-2
chancelot grove	 tuesday-2	 friday-1
chapel street	None	 thursday-1
charterhall grove	 tuesday-2	 tuesday-2
charterhall road	 tuesday-2	 tuesday-2
cherry tree avenue	 wednesday-1	 wednesday-1
cherry tree crescent	 wednesday-1	 wednesday-1
cherry tree gardens	 wednesday-1	 wednesday-1
cherry tree grove	 wednesday-1	 wednesday-1
cherry tree loan	 wednesday-1	 wednesday-1
cherry tree park	 wednesday-1	 wednesday-1
cherry tree place	 wednesday-1	 wednesday-1
cherry tree view	 wednesday-1	 wednesday-1
chesser avenue	 tuesday-2	 friday-2
chesser cottages	 tuesday-2	 friday-2
chesser crescent	 tuesday-2	 friday-2
chesser gardens	 tuesday-2	 friday-2
chesser grove	 tuesday-2	 friday-2
chesser loan	 tuesday-2	 friday-2
chester street	 tuesday-1	 tuesday-1
christian crescent	 friday-2	 wednesday-1
christian grove	 friday-2	 wednesday-1
christie miller avenue	 wednesday-2	 tuesday-2
christie miller grove	 wednesday-2	 tuesday-2
christie miller place	 wednesday-2	 tuesday-2
christie road	 wednesday-1	 friday-2
church hill	 tuesday-2	 tuesday-2
churchhill drive	 tuesday-2	 tuesday-2
circus lane	 wednesday-1	 tuesday-2
citadel place	 wednesday-1	 friday-1
clackmae grove	 thursday-2	 wednesday-2
clackmae road	 thursday-2	 wednesday-2
clapper lane	 thursday-2	 wednesday-2
clarebank crescent	 wednesday-1	 wednesday-1
claremont bank	 wednesday-1	 tuesday-2
claremont crescent	 wednesday-1	 thursday-1
claremont gardens	 wednesday-1	 wednesday-1
claremont grove	 wednesday-1	 tuesday-2
claremont park	 wednesday-1	 wednesday-1
claremont road	 wednesday-1	 wednesday-1
clarence street	 wednesday-1	 tuesday-2
clarendon crescent	 tuesday-1	 thursday-2
clarinda terrace	 thursday-1	 friday-1
clark avenue	 tuesday-2	 tuesday-1
clark place	None	 wednesday-1
claverhouse drive	 thursday-2	 friday-1
clayhills grove	 wednesday-1	 thursday-1
clayhills park	 wednesday-1	 thursday-1
clearburn crescent	 friday-1	 thursday-1
clearburn gardens	 friday-1	 thursday-1
clearburn road	 friday-1	 thursday-1
cleekim drive	 friday-1	 thursday-1
cleekim road	 friday-1	 thursday-1
cleghorn road	 tuesday-1	 thursday-2
cleikiminfield	 wednesday-1a	 thursday-1
cleikiminrig	 wednesday-1a	 thursday-1
cleric's hill	 thursday-1	 thursday-1
clermiston avenue	 friday-1	 tuesday-2
clermiston crescent	 friday-1	 tuesday-2
clermiston drive	 friday-1	 tuesday-2
clermiston gardens	 friday-1	 tuesday-2
clermiston green	 friday-1	 tuesday-2
clermiston grove	 friday-1	 tuesday-2
clermiston hill	 friday-1	 tuesday-2
clermiston loan	 friday-1	 tuesday-2
clermiston medway	 friday-1	 tuesday-2
clermiston park	 friday-1	 tuesday-2
clermiston place	 friday-1	 tuesday-2
clermiston road north	 friday-1	 tuesday-2
clermiston terrace	 friday-1	 friday-2
clermiston view	 friday-1	 tuesday-2
clerwood bank	 friday-1	 wednesday-2
clerwood gardens	 friday-1	 wednesday-2
clerwood grove	 friday-1	 thursday-2
clerwood loan	 friday-1	 wednesday-2
clerwood park	 friday-1	 wednesday-2
clerwood place	 friday-1	 thursday-2
clerwood row	 friday-1	 wednesday-2
clerwood terrace	 friday-1	 thursday-2
clerwood view	 friday-1	 thursday-2
clerwood way	 friday-1	 wednesday-2
clifton road	 thursday-1	 tuesday-1
clifton terrace	None	 tuesday-1
cliftonhall road	 thursday-1	 tuesday-1
clinton road	 tuesday-2	 tuesday-2
clippens drive	 thursday-1	 thursday-2
clovenstone drive	 wednesday-1	 wednesday-2
clovenstone gardens	 wednesday-1	 wednesday-2
clovenstone park	 wednesday-1	 wednesday-2
clufflat	 thursday-1	 tuesday-1
clufflat brae	 thursday-1	 tuesday-1
cluny avenue	 tuesday-2	 wednesday-2
cluny drive	 tuesday-1	 wednesday-2
cluny gardens	None	 wednesday-2
cluny place	 tuesday-1	 wednesday-2
cluny terrace	 tuesday-2	 wednesday-2
coates gardens	 tuesday-1	 tuesday-1
cobbler's close	 thursday-1	 tuesday-1
cobden crescent	 wednesday-1	 thursday-1
cobden road	 wednesday-1	 thursday-1
cobden terrace	 tuesday-1	 wednesday-1
cochran terrace	 wednesday-1	 tuesday-2
cochrane place	 wednesday-1	 thursday-2
cockburn crescent	 wednesday-1	 thursday-1
cockburnhill road	 wednesday-1	 friday-1
coillesdene avenue	 friday-2	 tuesday-1
coillesdene crescent	 friday-2	 tuesday-1
coillesdene drive	 friday-2	 tuesday-1
coillesdene gardens	 friday-2	 tuesday-1
coillesdene grove	 friday-2	 tuesday-1
coillesdene loan	 friday-2	 tuesday-1
coillesdene terrace	 friday-2	 tuesday-1
colinton grove	 wednesday-2	 tuesday-1
colinton grove west	 wednesday-2	 tuesday-1
colinton mains crescent	 tuesday-1	 tuesday-1
colinton mains drive	 tuesday-1	 tuesday-1
colinton mains gardens	 tuesday-1	 tuesday-1
colinton mains green	 tuesday-1	 tuesday-1
colinton mains grove	 tuesday-1	 tuesday-1
colinton mains loan	 tuesday-1	 thursday-1
colinton mains place	 tuesday-1	 tuesday-1
colinton mains road	 tuesday-1	 tuesday-1
colinton mains terrace	 tuesday-1	 tuesday-1
collier place	 friday-1	 tuesday-2
collins place	 tuesday-1	 tuesday-2
colmestone gate	 tuesday-1	 thursday-2
coltbridge avenue	 friday-1	 wednesday-1
coltbridge gardens	 friday-1	 wednesday-1
coltbridge terrace	 friday-1	 wednesday-1
coltbridge vale	 friday-1	 wednesday-1
columba avenue	 friday-2	 wednesday-2
columba road	 friday-2	 wednesday-2
colville place	 tuesday-1	 tuesday-2
combe road	 wednesday-1	 thursday-2
comely bank	 tuesday-2	 thursday-2
comely bank avenue	None	 thursday-2
comely bank grove	 tuesday-1	 thursday-2
comely bank place	None	 thursday-2
comely bank place mews	 tuesday-1	 tuesday-2
comely bank road	 tuesday-2	 thursday-2
comely bank row	None	 thursday-2
comely bank street	 tuesday-1	 thursday-2
comely bank terrace	None	 thursday-2
comiston drive	 tuesday-1	 thursday-1
comiston gardens	 tuesday-1	 thursday-1
comiston grove	 tuesday-1	 thursday-2
comiston place	 tuesday-1	 wednesday-2
comiston rise	 tuesday-1	 thursday-2
comiston road	 tuesday-1	 thursday-1
comiston springs avenue	 tuesday-1	 thursday-2
comiston terrace	None	 wednesday-2
comiston view	 tuesday-1	 thursday-2
commercial street	 wednesday-1	 friday-1
connaught place	 tuesday-2	 friday-1
considine gardens	 wednesday-2	 thursday-1
considine terrace	 wednesday-2	 thursday-1
corbiehill avenue	 friday-2	 wednesday-2
corbiehill crescent	 friday-1	 thursday-1
corbiehill gardens	 friday-2	 wednesday-2
corbiehill grove	 friday-2	 wednesday-2
corbiehill park	 friday-2	 wednesday-2
corbiehill place	 friday-1	 thursday-1
corbiehill road	 friday-1	 wednesday-2
corbiehill terrace	 friday-1	 thursday-1
corbieshot	 friday-1	 thursday-1
corbiewynd	 friday-1	 thursday-1
cornfield crescent	 friday-1	 thursday-2
cornhill terrace	 wednesday-1	 thursday-2
corrennie drive	 tuesday-1	 wednesday-2
corrennie gardens	 tuesday-1	 wednesday-2
corrigan street	 wednesday-1a	 thursday-1
corslet crescent	 wednesday-1	 tuesday-1
corslet road	 wednesday-1	 tuesday-1
corstorphine bank avenue	 friday-1	 wednesday-2
corstorphine bank drive	 friday-1	 wednesday-2
corstorphine bank terrace	 friday-1	 wednesday-2
corstorphine high street	 friday-1	 wednesday-2
corstorphine hill avenue	 friday-1	 friday-2
corstorphine hill crescent	 friday-1	 friday-2
corstorphine hill gardens	 friday-1	 friday-2
corstorphine hill road	 friday-1	 friday-2
corstorphine house avenue	 friday-1	 friday-2
corstorphine house terrace	 friday-1	 friday-2
corstorphine park gardens	 friday-1	 friday-2
cotlaws	 thursday-1	 thursday-1
cottage green	 friday-1	 wednesday-1
cottage park	 friday-2	 friday-1
coulter crescent	 thursday-2	 thursday-2
cowan road	 tuesday-2	 friday-1
cowan's close	None	 thursday-1
cowgill gardens	 thursday-2	 thursday-2
craigcrook avenue	 friday-2	 friday-1
craigcrook gardens	 friday-2	 wednesday-2
craigcrook grove	 friday-2	 friday-1
craigcrook park	 friday-2	 friday-1
craigcrook place	 friday-2	 wednesday-2
craigcrook square	 friday-2	 friday-1
craigcrook terrace	 friday-2	 wednesday-2
craigentarrie mews	 wednesday-1	 wednesday-1
craigentinny avenue north	 wednesday-1	 wednesday-1
craigentinny crescent	 wednesday-2	 tuesday-2
craigentinny grove	 wednesday-2	 tuesday-2
craigentinny place	 wednesday-2	 friday-2
craighall avenue	 wednesday-1	 tuesday-1
craighall bank	 wednesday-1	 tuesday-1
craighall crescent	 tuesday-2	 tuesday-1
craighall gardens	 tuesday-2	 tuesday-1
craighall road	 tuesday-2	 tuesday-1
craighall terrace	 tuesday-2	 tuesday-1
craighill gardens	 tuesday-1	 thursday-1
craighouse avenue	 tuesday-1	 thursday-1
craighouse gardens	 tuesday-1	 thursday-1
craighouse park	 tuesday-1	 thursday-1
craighouse road	 tuesday-1	 thursday-1
craighouse terrace	 tuesday-1	 thursday-1
craigievar square	 thursday-2	 friday-2
craigievar wynd	 thursday-2	 friday-2
craiglea drive	 tuesday-1	 thursday-1
craiglea place	 tuesday-1	 thursday-1
craigleith avenue north	 friday-2	 wednesday-2
craigleith bank	 friday-2	 wednesday-2
craigleith drive	 friday-2	 wednesday-2
craigleith gardens	 friday-2	 wednesday-2
craigleith grove	 friday-2	 wednesday-2
craigleith hill	 tuesday-2	 wednesday-2
craigleith hill avenue	 tuesday-2	 wednesday-2
craigleith hill crescent	 tuesday-2	 wednesday-2
craigleith hill gardens	 tuesday-2	 wednesday-2
craigleith hill green	 tuesday-2	 wednesday-2
craigleith hill grove	 tuesday-2	 wednesday-2
craigleith hill loan	 tuesday-2	 wednesday-2
craigleith hill park	 tuesday-2	 wednesday-2
craigleith hill row	 tuesday-2	 wednesday-2
craigleith rise	 friday-2	 tuesday-1
craigleith road	None	 wednesday-2
craigleith view	 friday-2	 tuesday-1
craiglockhart avenue	 tuesday-2	 wednesday-1
craiglockhart bank	 tuesday-2	 wednesday-1
craiglockhart crescent	 tuesday-2	 wednesday-1
craiglockhart dell road	 tuesday-2	 wednesday-1
craiglockhart drive north	 tuesday-2	 wednesday-1
craiglockhart drive south	 tuesday-2	 wednesday-1
craiglockhart gardens	 tuesday-2	 wednesday-1
craiglockhart grove	 tuesday-2	 wednesday-1
craiglockhart loan	 tuesday-2	 wednesday-1
craiglockhart park	 tuesday-2	 wednesday-1
craiglockhart place	 wednesday-2	 wednesday-1
craiglockhart quadrant	 tuesday-2	 wednesday-1
craiglockhart road	 tuesday-2	 wednesday-1
craiglockhart terrace	 wednesday-2	 friday-1
craiglockhart view	 wednesday-2	 tuesday-1
craigmillar castle avenue	 friday-1	 tuesday-2
craigmillar castle gardens	 friday-1	 tuesday-2
craigmillar castle loan	 friday-1	 tuesday-2
craigmillar castle road	 friday-1	 tuesday-2
craigmillar park	 thursday-2	 tuesday-1
craigmount avenue	 thursday-2	 thursday-2
craigmount avenue north	 thursday-2	 thursday-2
craigmount bank	 thursday-2	 thursday-2
craigmount bank west	 thursday-2	 thursday-2
craigmount brae	 thursday-2	 thursday-2
craigmount court	 thursday-2	 thursday-2
craigmount crescent	 thursday-2	 thursday-2
craigmount drive	 thursday-2	 thursday-2
craigmount gardens	 thursday-2	 thursday-2
craigmount grove	 thursday-2	 thursday-2
craigmount grove north	 thursday-2	 thursday-2
craigmount hill	 thursday-2	 thursday-2
craigmount loan	 thursday-2	 thursday-2
craigmount park	 thursday-2	 thursday-2
craigmount place	 thursday-2	 thursday-2
craigmount terrace	 thursday-2	 thursday-2
craigmount view	 thursday-2	 thursday-2
craigmount way	 thursday-2	 thursday-2
craigmuir place	 tuesday-1	 friday-2
craigour avenue	 thursday-1	 friday-1
craigour crescent	 thursday-1	 friday-1
craigour drive	 thursday-1	 friday-1
craigour gardens	 thursday-1	 friday-1
craigour grove	 thursday-1	 friday-1
craigour loan	 thursday-1	 friday-1
craigour terrace	 thursday-1	 friday-1
craigpark avenue	 thursday-1	 wednesday-2
craigpark crescent	 thursday-1	 wednesday-2
craigroyston grove	 tuesday-1	 thursday-2
craigroyston place	 tuesday-1	 thursday-2
craigs avenue	 thursday-2	 friday-1
craigs bank	 thursday-2	 friday-1
craigs crescent	 thursday-2	 friday-1
craigs drive	 thursday-2	 friday-2
craigs gardens	 thursday-2	 friday-1
craigs grove	 thursday-2	 friday-1
craigs loan	 thursday-2	 friday-1
craigs park	 thursday-2	 friday-2
cramond avenue	 friday-1	 wednesday-1
cramond bank	 friday-1	 wednesday-1
cramond bridge	 friday-1	 tuesday-1
cramond crescent	 friday-1	 wednesday-1
cramond gardens	 friday-1	 wednesday-1
cramond glebe gardens	 friday-1	 wednesday-1
cramond glebe road	 friday-1	 wednesday-1
cramond glebe terrace	 friday-1	 wednesday-1
cramond green	 friday-1	 wednesday-1
cramond grove	 friday-1	 wednesday-1
cramond park	 friday-1	 wednesday-1
cramond place	 friday-1	 wednesday-1
cramond regis	 friday-1	 wednesday-1
cramond road north	 friday-1	 wednesday-1
cramond road south	 friday-1	 thursday-1
cramond terrace	 friday-1	 wednesday-1
cramond vale	 friday-1	 wednesday-1
cramond village	 friday-1	 wednesday-1
crarae avenue	 friday-2	 tuesday-1
craw yard drive	 thursday-2	 friday-1
craw yard place	 thursday-2	 friday-1
craw's close	 thursday-1	 wednesday-1
crawford gait	 thursday-1	 tuesday-2
crawford green	 thursday-1	 tuesday-2
crawfurd road	 thursday-2	 tuesday-1
crewe bank	 tuesday-1	 friday-2
crewe crescent	 tuesday-1	 friday-2
crewe grove	 tuesday-1	 friday-2
crewe loan	 tuesday-1	 friday-2
crewe place	 tuesday-1	 friday-2
crewe road gardens	 tuesday-1	 friday-2
crewe road north	 tuesday-1	 tuesday-2
crewe road west	 tuesday-1	 tuesday-2
crewe terrace	 tuesday-1	 friday-2
cromwell place	 wednesday-1	 friday-1
crosswood avenue	 wednesday-1	 thursday-1
crosswood crescent	 wednesday-1	 thursday-1
cuddy lane	None	 tuesday-2
cullet walk	 friday-2	 tuesday-2
cumberland street	 wednesday-1	 tuesday-2
cumberland street south east lane	 wednesday-1	 tuesday-2
cumin place	 tuesday-2	 wednesday-1
cumlodden avenue	 friday-2	 tuesday-1
cumnor crescent	 thursday-2	 friday-1
curriehill castle drive	 wednesday-1	 wednesday-1
currievale drive	 wednesday-1	 friday-2
currievale farm	 wednesday-1	 friday-1
currievale park	 wednesday-1	 friday-2
currievale park grove	 wednesday-1	 friday-2
daiches braes	 friday-2	 wednesday-1
daisy terrace	 tuesday-2	 wednesday-1
dalgety avenue	None	 thursday-1
dalgety road	None	 thursday-1
dalgety street	None	 thursday-1
dalhousie terrace	 tuesday-1	 thursday-1
dalkeith road	None	 thursday-1
dalkeith street	 friday-2	 tuesday-1
dalmahoy	 thursday-1	 tuesday-1
dalmahoy crescent	 wednesday-1	 friday-1
dalmahoy road	 thursday-1	 wednesday-2
dalmeny estate	 thursday-1	 tuesday-1
dalmeny road	 tuesday-2	 friday-1
dalmeny street	 wednesday-1	 thursday-1
dalry road	 tuesday-2	 wednesday-1
dalrymple crescent	 tuesday-2	 tuesday-1
dalziel place	None	 thursday-1
damselfly road	 wednesday-1	 thursday-2
damselfly view	 wednesday-1	 thursday-2
dania court	 thursday-2	 tuesday-2
danube street	 tuesday-1	 thursday-2
darnaway street	 wednesday-1	 tuesday-2
darnell road	 tuesday-2	 wednesday-1
darnley terrace	 friday-1	 tuesday-2
davidson gardens	 friday-1	 thursday-1
davidson park	 friday-2	 tuesday-2
davidson road	 friday-2	 tuesday-2
dean bank lane	None	 tuesday-2
dean park crescent	 wednesday-1	 thursday-2
dean park mews	 tuesday-1	 thursday-2
dean park street	None	 thursday-2
dean path	 wednesday-1	 wednesday-1
dean street	 wednesday-1	 thursday-2
deanpark avenue	 wednesday-1	 thursday-1
deanpark bank	 wednesday-1	 thursday-1
deanpark brae	 wednesday-1	 thursday-1
deanpark court	 wednesday-1	 thursday-1
deanpark crescent	 wednesday-1	 thursday-1
deanpark gardens	 wednesday-1	 thursday-1
deanpark grove	 wednesday-1	 thursday-1
deanpark place	 wednesday-1	 thursday-1
deanpark square	 wednesday-1	 thursday-1
dechmont road	 thursday-2	 friday-1
dell road	 wednesday-1	 thursday-1
denham green avenue	 tuesday-2	 wednesday-1
denham green place	 tuesday-2	 wednesday-1
denham green terrace	 tuesday-2	 wednesday-1
derby street	 wednesday-1	 thursday-2
devon gardens	 tuesday-2	 wednesday-1
devon place	 tuesday-2	 wednesday-1
dick place	 tuesday-2	 wednesday-1
dickson street	None	 thursday-1
dimma park	 thursday-1	 tuesday-2
dinmont drive	 friday-1	 friday-1
dochart drive	 friday-1	 thursday-2
dock street	 wednesday-1	 friday-1
dolphin avenue	 wednesday-1	 wednesday-1
dolphin gardens east	 wednesday-1	 wednesday-1
dolphin gardens west	 wednesday-1	 wednesday-1
dolphin road	 wednesday-1	 wednesday-1
donaldson crescent	 tuesday-2	 tuesday-1
double hedges park	 thursday-2	 friday-1
double hedges road	 thursday-2	 friday-1
douglas crescent	 tuesday-1	 tuesday-1
douglas gardens	 tuesday-1	 wednesday-1
douglas terrace	 tuesday-1	 wednesday-1
doune terrace	 wednesday-1	 tuesday-2
dovecot grove	 tuesday-2	 thursday-2
dovecot loan	 tuesday-2	 thursday-2
dovecot park	 wednesday-1	 thursday-2
dovecot road	 friday-1	 tuesday-2
dowies mill lane	 friday-1	 wednesday-1
downie grove	 friday-1	 friday-2
downie terrace	 friday-1	 friday-2
dreghorn drive	 wednesday-2	 friday-1
dreghorn gardens	 wednesday-2	 friday-1
dreghorn link	 wednesday-2	 friday-1
dreghorn loan	 wednesday-2	 tuesday-2
dreghorn park	 wednesday-1	 thursday-1
dreghorn place	 wednesday-2	 friday-1
drum avenue	 thursday-1	 friday-1
drum brae avenue	 friday-1	 thursday-2
drum brae crescent	 friday-1	 thursday-2
drum brae gardens	 friday-1	 thursday-2
drum brae grove	 friday-1	 thursday-2
drum brae neuk	 friday-1	 thursday-2
drum brae park	 friday-1	 thursday-2
drum brae park approach	 friday-1	 thursday-2
drum brae place	 friday-1	 thursday-2
drum brae south	None	 thursday-2
drum brae terrace	 friday-1	 thursday-2
drum brae walk	 thursday-2	 thursday-2
drum cottages	 thursday-1	 friday-2
drum crescent	 thursday-1	 friday-1
drum place	 thursday-1	 friday-1
drum woods	 thursday-1	 friday-1
drummond place	 wednesday-1	 tuesday-2
drumsheugh gardens	 tuesday-1	 tuesday-1
dryden gait	 wednesday-1	 thursday-1
dryden gardens	 wednesday-1	 thursday-1
dryden place	 wednesday-1	 thursday-1
dryden street	 wednesday-1	 thursday-1
dryden terrace	 wednesday-1	 thursday-1
drylaw avenue	 friday-2	 wednesday-2
drylaw crescent	 friday-2	 wednesday-2
drylaw gardens	 friday-2	 wednesday-2
drylaw green	 friday-2	 wednesday-2
drylaw grove	 friday-2	 wednesday-2
drylaw house gardens	 friday-2	 friday-2
drylaw house paddock	 friday-2	 friday-2
duart crescent	 friday-1	 thursday-2
dublin street	 wednesday-1	 tuesday-2
dublin street lane north	 wednesday-1	 tuesday-2
dublin street lane south	 wednesday-1	 tuesday-2
duddingston avenue	 friday-2	 thursday-2
duddingston crescent	 friday-2	 wednesday-1
duddingston gardens north	 friday-2	 friday-2
duddingston gardens south	 friday-2	 friday-2
duddingston grove east	 friday-2	 friday-2
duddingston grove west	 friday-2	 friday-2
duddingston loan	 friday-2	 thursday-2
duddingston mains cottages	 friday-2	 wednesday-1
duddingston mills	 friday-2	 thursday-2
duddingston park	 friday-2	 wednesday-1
duddingston park south	 friday-2	 thursday-1
duddingston rise	 friday-2	 friday-2
duddingston road	 friday-2	 thursday-2
duddingston row	 friday-2	 friday-2
duddingston square east	 friday-2	 friday-2
duddingston square west	 friday-2	 friday-2
duddingston view	 friday-2	 friday-2
dudgeon place	 thursday-1	 tuesday-2
dudley avenue	 wednesday-1	 friday-1
dudley bank	 wednesday-1	 friday-1
dudley crescent	 wednesday-1	 friday-1
dudley gardens	 wednesday-1	 friday-1
dudley grove	 wednesday-1	 friday-1
dudley terrace	 wednesday-1	 friday-1
duff street	None	 tuesday-1
duke street	None	 wednesday-1
dumbeg park	 wednesday-2	 wednesday-2
dumbryden gardens	 wednesday-2	 wednesday-2
duncan street	 tuesday-2	 tuesday-1
dundas avenue	 thursday-1	 wednesday-1
dundas home farm	 thursday-1	 tuesday-1
dundas place	 thursday-1	 tuesday-2
dundas street	 wednesday-1	 tuesday-2
dundee terrace	 tuesday-1	 friday-1
dundrennan cottages	 friday-1	 wednesday-2
dunedin street	 wednesday-1	 friday-1
dunipace road	 thursday-2	 friday-1
dunkeld street	 friday-1	 tuesday-2
dunlaw wynd	 thursday-2	 thursday-2
dunnet grove	 thursday-1	 thursday-2
dunnikier way	 thursday-2	 wednesday-2
dunollie court	 thursday-2	 friday-2
dunrobin place	 tuesday-1	 tuesday-2
dunsmuir court	 friday-1	 wednesday-2
duntreath place	 friday-1	 tuesday-2
duntreath road	 friday-1	 tuesday-2
dunvegan court	 friday-1	 wednesday-1
durar drive	 friday-1	 thursday-2
durham avenue	 friday-2	 friday-2
durham drive	 friday-2	 friday-2
durham gardens north	 friday-2	 friday-2
durham gardens south	 friday-2	 friday-2
durham grove	 friday-2	 friday-2
durham place east	 friday-2	 friday-2
durham road	 friday-2	 friday-2
durham road south	 friday-2	 friday-2
durham square	 friday-2	 friday-2
durham terrace	 friday-2	 thursday-2
durie loan	 thursday-1	 thursday-2
durward grove	 friday-1	 friday-1
east barnton avenue	 friday-1	 thursday-1
east barnton gardens	 friday-1	 thursday-1
east brighton crescent	 friday-2	 wednesday-1
east caiystane place	 tuesday-1	 thursday-1
east caiystane road	 tuesday-1	 thursday-1
east camus place	 tuesday-1	 thursday-2
east castle road	 tuesday-2	 tuesday-2
east champanyie	 tuesday-2	 tuesday-2
east clapperfield	 thursday-2	 friday-1
east claremont street	 wednesday-1	 thursday-1
east comiston	 tuesday-1	 thursday-2
east craigs rigg	 thursday-2	 friday-1
east craigs wynd	 thursday-2	 friday-1
east croft	 thursday-1	 wednesday-2
east farm of gilmerton	 thursday-1	 friday-1
east fettes avenue	 tuesday-2	 thursday-2
east hannahfield	 wednesday-1	 friday-1
east hermitage place	 wednesday-1	 wednesday-1
east kilngate place	 thursday-1	 friday-2
east kilngate rigg	 thursday-1	 friday-2
east kilngate wynd	 thursday-1	 friday-2
east lillypot	 tuesday-2	 tuesday-1
east london street	 wednesday-1	 tuesday-2
east market street	None	 thursday-1
east mayfield	 wednesday-1	 thursday-1
east newington place	 wednesday-1	 wednesday-2
east parkside	 friday-1	 wednesday-2
east pilton farm crescent	 tuesday-2	 thursday-1
east pilton farm wynd	 tuesday-2	 thursday-1
east preston street	None	 wednesday-2
east restalrig terrace	 wednesday-1	 thursday-2
east savile road	 tuesday-2	 tuesday-1
east scotland street lane	None	 tuesday-2
east suffolk park	 thursday-2	 tuesday-1
east suffolk road	 thursday-2	 tuesday-1
east terrace	 thursday-1	 tuesday-1
easter belmont road	 friday-1	 thursday-1
easter currie court	 wednesday-1	 friday-2
easter currie crescent	 wednesday-1	 tuesday-1
easter currie place	 wednesday-1	 tuesday-1
easter currie terrace	 wednesday-1	 tuesday-1
easter dalmeny	 thursday-1	 tuesday-1
easter drylaw avenue	 friday-2	 friday-2
easter drylaw bank	 friday-2	 friday-2
easter drylaw drive	 friday-2	 friday-2
easter drylaw gardens	 friday-2	 friday-2
easter drylaw grove	 friday-2	 friday-2
easter drylaw loan	 friday-2	 friday-2
easter drylaw place	 friday-2	 friday-2
easter drylaw view	 friday-2	 friday-2
easter drylaw way	 friday-2	 friday-2
easter hermitage	 wednesday-1	 wednesday-1
easter park drive	 friday-1	 thursday-1
easter road	 wednesday-2	 thursday-1
easter steil	 tuesday-1	 tuesday-1
easter warriston	 tuesday-1	 tuesday-2
eastfield	 friday-2	 tuesday-1
eastfield gardens	 friday-2	 tuesday-1
eastfield place	 friday-2	 tuesday-1
echline	 thursday-1	 tuesday-1
echline drive	 thursday-1	 tuesday-1
echline gardens	 thursday-1	 tuesday-1
echline green	 thursday-1	 tuesday-1
echline grove	 thursday-1	 tuesday-1
echline park	 thursday-1	 tuesday-1
echline place	 thursday-1	 tuesday-1
echline terrace	 thursday-1	 tuesday-1
echline view	 thursday-1	 tuesday-1
eden lane	 tuesday-1	 tuesday-2
eden terrace	 tuesday-1	 tuesday-2
edgelaw rigg	 thursday-2	 thursday-2
edwards wynd	 wednesday-1	 friday-1
eglinton crescent	 tuesday-1	 tuesday-1
eildon street	 tuesday-1	 friday-1
eildon terrace	 tuesday-2	 friday-1
eilston drive	 thursday-1	 thursday-1
eilston loan	 thursday-1	 thursday-1
eilston road	 thursday-1	 thursday-1
eilston terrace	 thursday-1	 thursday-1
elcho terrace	 friday-2	 tuesday-1
elgin street	 wednesday-2	 thursday-1
elgin terrace	None	 thursday-1
eliza wigham bow	 wednesday-1	 thursday-2
ellangowan terrace	 friday-1	 wednesday-2
ellen's glen loan	 thursday-1	 wednesday-2
ellersly road	 friday-2	 tuesday-1
elliot gardens	 wednesday-2	 wednesday-1
elliot park	 wednesday-2	 wednesday-1
elliot place	 wednesday-2	 wednesday-1
elliot road	 wednesday-2	 wednesday-1
ellis drive	 wednesday-2	 tuesday-2
ellis street	 thursday-2	 wednesday-2
elm place	 wednesday-1	 thursday-2
elmwood terrace	 wednesday-1	 thursday-2
eltringham gardens	 tuesday-2	 friday-2
eltringham grove	 tuesday-2	 friday-2
eltringham terrace	 tuesday-1	 wednesday-1
erroll drive	 friday-1	 tuesday-2
esdaile bank	 tuesday-1	 wednesday-2
esplanade terrace	 friday-1	 friday-2
essendean place	 friday-1	 thursday-2
essendean terrace	None	 thursday-2
essex brae	 friday-1	 wednesday-1
essex park	 friday-1	 wednesday-1
essex road	 friday-1	 wednesday-1
esslemont road	 thursday-2	 tuesday-1
ethel terrace	 tuesday-1	 thursday-1
eton terrace	 tuesday-1	 thursday-2
ettrick grove	 tuesday-2	 tuesday-2
ettrick loan	 tuesday-2	 friday-1
ettrick road	 tuesday-2	 friday-1
ettrickdale place	 tuesday-1	 tuesday-2
eva place	 tuesday-2	 tuesday-2
ewerland	 friday-1	 tuesday-1
eyre crescent	 wednesday-1	 tuesday-2
eyre place	 wednesday-1	 tuesday-2
eyre place lane	 wednesday-1	 tuesday-2
fair-a-far	 friday-1	 wednesday-1
fair-a-far shot	 friday-1	 wednesday-1
fairbairn street	 wednesday-1	 friday-1
fairbrae	 thursday-2	 thursday-2
fairfield gardens	 tuesday-1	 friday-2
fairford gardens	 friday-1	 friday-1
fairholm mews	 tuesday-2	 wednesday-2
fairmile avenue	 tuesday-1	 thursday-1
fala place	 thursday-2	 wednesday-2
falcon avenue	None	 tuesday-2
falcon court	None	 wednesday-2
falcon gardens	None	 tuesday-2
falcon road	None	 tuesday-2
falcon road west	None	 tuesday-2
falkland gardens	 friday-1	 thursday-2
farquhar terrace	 thursday-1	 tuesday-1
farrer grove	 wednesday-2	 tuesday-2
farrer terrace	 wednesday-2	 tuesday-2
fauldburn	 thursday-2	 friday-2
fauldburn park	 thursday-2	 friday-2
featherhall avenue	 friday-1	 wednesday-2
featherhall crescent north	 friday-1	 wednesday-2
featherhall crescent south	 friday-1	 wednesday-2
featherhall grove	 friday-1	 wednesday-2
featherhall place	 friday-1	 thursday-1
featherhall road	 friday-1	 wednesday-2
featherhall terrace	 friday-1	 thursday-1
ferguson rigg	 wednesday-1a	 thursday-1
fernieflat neuk	 wednesday-2	 thursday-2
ferniehill avenue	 thursday-1	 friday-1
ferniehill drive	 thursday-1	 friday-1
ferniehill gardens	 thursday-1	 friday-1
ferniehill grove	 thursday-1	 friday-1
ferniehill place	 thursday-1	 friday-1
ferniehill road	 thursday-1	 friday-1
ferniehill square	 thursday-1	 friday-1
ferniehill street	 thursday-1	 friday-1
ferniehill terrace	 thursday-1	 friday-1
ferniehill way	 thursday-1	 friday-1
fernielaw avenue	 wednesday-2	 tuesday-2
fernieside avenue	 thursday-1	 friday-1
fernieside crescent	 thursday-1	 friday-1
fernieside drive	 thursday-1	 friday-1
fernieside gardens	 thursday-1	 friday-1
fernieside grove	 thursday-1	 friday-1
fernieside place	 thursday-1	 friday-1
ferrier medway	 wednesday-1	 friday-2
ferry gait drive	 tuesday-1	 thursday-2
ferry gait gardens	 tuesday-1	 thursday-2
ferry gait walk	 tuesday-1	 thursday-2
ferry road	 friday-2	 friday-1
ferry road avenue	None	 friday-2
ferry road drive	 tuesday-1	 friday-2
ferry road gardens	 tuesday-1	 friday-2
ferry road grove	 tuesday-1	 friday-2
ferry road place	 tuesday-1	 friday-2
ferryburn	 thursday-1	 wednesday-1
ferryburn green	 thursday-1	 wednesday-1
ferryfield	 tuesday-2	 thursday-1
ferrymuir lane	 thursday-1	 wednesday-1
fettes rise	 tuesday-2	 friday-1
fettes row	 wednesday-1	 tuesday-2
fillyside avenue	 wednesday-2	 tuesday-2
fillyside road	 wednesday-2	 tuesday-2
fillyside terrace	 wednesday-2	 tuesday-2
findhorn place	 tuesday-2	 tuesday-1
findlay avenue	 wednesday-1	 wednesday-1
findlay cottages	 wednesday-1	 tuesday-1
findlay gardens	 wednesday-1	 tuesday-1
findlay grove	 wednesday-1	 tuesday-1
findlay medway	 wednesday-1	 tuesday-1
fingal place	 tuesday-1	 wednesday-1
finlaggan court	 thursday-2	 friday-2
fireclay walk	 friday-1	 thursday-1
firrhill crescent	 tuesday-1	 tuesday-1
firrhill loan	 tuesday-1	 tuesday-1
firrhill park	 tuesday-1	 wednesday-1
fisher place	 thursday-2	 wednesday-2
fishwives causeway	 friday-1	 tuesday-2
fleming place	 wednesday-1	 tuesday-1
fletcher crescent	 wednesday-1	 friday-1
flint terrace	 friday-2	 tuesday-2
flockhart gait	 wednesday-1a	 thursday-1
florence mcneill street	None	 friday-2
forbes road	 tuesday-2	 tuesday-2
forbes street	 friday-1	 wednesday-2
ford's road	 wednesday-2	 tuesday-2
forrester park avenue	 friday-1	 tuesday-2
forrester park drive	 friday-1	 tuesday-2
forrester park gardens	 friday-1	 tuesday-2
forrester park green	 friday-1	 tuesday-2
forrester park grove	 friday-1	 tuesday-2
forrester park loan	 friday-1	 tuesday-2
forrester road	 friday-1	 friday-2
forth park	 thursday-1	 wednesday-1
forth place	 thursday-1	 tuesday-1
forth street	 wednesday-1	 tuesday-2
forth terrace	 thursday-1	 wednesday-1
forth view avenue	 wednesday-1	 wednesday-1
forth view road	 wednesday-1	 wednesday-1
forthview road	 friday-2	 wednesday-2
forthview terrace	 friday-2	 wednesday-2
foulis crescent	 wednesday-1	 tuesday-1
fountainhall road	 tuesday-2	 tuesday-1
fowler terrace	None	 friday-1
fox covert avenue	 friday-1	 thursday-2
fox covert grove	 friday-1	 thursday-2
fox spring crescent	 tuesday-1	 thursday-2
fox spring rise	 tuesday-1	 thursday-2
fraser avenue	 tuesday-2	 thursday-1
fraser crescent	 tuesday-2	 thursday-1
fraser gardens	 tuesday-2	 thursday-1
fraser grove	 tuesday-2	 thursday-1
freelands road	 thursday-1	 wednesday-2
freelands way	 thursday-1	 wednesday-2
friary road	 friday-1	 tuesday-2
frogston avenue	 tuesday-1	 tuesday-1
frogston gardens	 tuesday-1	 tuesday-1
frogston grove	 tuesday-1	 tuesday-1
frogston road east	 thursday-1	 wednesday-2
frogston road west	 tuesday-1	 tuesday-1
frogston terrace	 tuesday-1	 tuesday-1
fyfe way	 thursday-1	 wednesday-1
galachlaw shot	 tuesday-1	 tuesday-1
galachlawside	 tuesday-1	 tuesday-1
galvane road	 friday-1	 tuesday-2
gamekeeper's loan	 friday-1	 wednesday-1
gamekeeper's park	 friday-1	 wednesday-1
gamekeeper's road	 friday-1	 wednesday-1
gardiner grove	 friday-2	 wednesday-2
gardiner road	 friday-2	 wednesday-2
gardiner terrace	 friday-2	 wednesday-2
gardner's crescent	None	 wednesday-1
garscube terrace	 friday-2	 tuesday-1
garvald street	 thursday-2	 wednesday-2
gayfield square	 wednesday-1	 tuesday-2
gifford crescent	 wednesday-1	 friday-1
gilberstoun	 friday-2	 wednesday-1
gilberstoun brig	 friday-2	 wednesday-1
gilberstoun loan	 friday-2	 wednesday-1
gilberstoun place	 friday-2	 wednesday-1
gilberstoun wynd	 friday-2	 wednesday-1
gillespie crescent	None	 tuesday-2
gillespie road	 wednesday-1	 thursday-2
gillespie street	 tuesday-2	 tuesday-2
gillon drive	 wednesday-1	 friday-1
gillsland park	 tuesday-1	 friday-1
gillsland road	 tuesday-2	 friday-1
gilmerton dykes avenue	 thursday-1	 friday-2
gilmerton dykes crescent	 thursday-1	 friday-2
gilmerton dykes drive	 thursday-1	 friday-2
gilmerton dykes gardens	 thursday-1	 friday-2
gilmerton dykes grove	 thursday-1	 friday-2
gilmerton dykes loan	 thursday-1	 friday-2
gilmerton dykes place	 thursday-1	 friday-2
gilmerton dykes road	 thursday-1	 friday-2
gilmerton dykes street	 thursday-1	 friday-2
gilmerton dykes terrace	 thursday-1	 friday-2
gilmerton dykes view	 thursday-1	 friday-2
gilmerton place	 thursday-1	 friday-2
gilmerton station road	 thursday-1	 friday-2
gilmore place	 tuesday-2	 tuesday-2
gilmour road	None	 tuesday-1
gladhouse place	 tuesday-1	 friday-2
gladstone place	None	 wednesday-1
gladstone terrace	 tuesday-1	 wednesday-1
glebe gardens	 friday-1	 thursday-1
glebe grove	 friday-1	 thursday-1
glebe road	 friday-1	 thursday-1
glebe terrace	 friday-1	 thursday-1
glen street	None	 wednesday-1
glenallan drive	 friday-1	 friday-1
glenallan loan	 friday-1	 friday-1
glenalmond place	 thursday-2	 thursday-2
glenbrook	 wednesday-1	 friday-1
glenbrook road	 wednesday-1	 friday-1
glencairn crescent	 tuesday-1	 tuesday-1
glendevon avenue	 friday-2	 wednesday-1
glendevon gardens	 friday-1	 thursday-1
glendevon grove	 friday-1	 thursday-1
glendevon park	 friday-2	 wednesday-1
glendevon place	 friday-2	 wednesday-1
glendevon road	 friday-2	 wednesday-1
glendevon terrace	 friday-1	 thursday-1
glendinning crescent	 thursday-2	 friday-1
glendinning drive	 thursday-1	 thursday-1
glendinning place	 thursday-1	 thursday-1
glendinning road	 thursday-1	 thursday-1
glendinning way	 thursday-1	 thursday-1
glenfinlas street	 wednesday-1	 wednesday-1
glengyle terrace	None	 wednesday-1
glenisla gardens	 tuesday-2	 tuesday-2
glenisla gardens lane	 tuesday-1	 tuesday-2
glenlea cottages	 tuesday-2	 friday-2
glenlee avenue	 wednesday-1	 thursday-2
glenlee gardens	 wednesday-1	 thursday-2
glenlockhart bank	 wednesday-2	 tuesday-1
glenlockhart road	 wednesday-2	 tuesday-1
glenlockhart valley	 wednesday-2	 tuesday-1
glenogle house	 tuesday-1	 tuesday-2
glenogle place	 tuesday-1	 tuesday-2
glenogle terrace	 tuesday-1	 tuesday-2
glenorchy terrace	 tuesday-2	 wednesday-2
glenure loan	 friday-1	 thursday-2
glenvarloch crescent	 thursday-2	 friday-1
gloucester square	 wednesday-1	 tuesday-2
goff avenue	 wednesday-2	 tuesday-2
gogar station road	 thursday-1	 friday-2
gogarbank	 thursday-1	 tuesday-1
gogarloch bank	 thursday-2	 friday-1
gogarloch haugh	 thursday-2	 friday-1
gogarloch muir	 thursday-2	 friday-1
gogarloch road	 thursday-2	 friday-1
gogarloch syke	 thursday-2	 friday-1
gogarmuir road	 thursday-1	 tuesday-1
gogarstone road	 thursday-1	 tuesday-1
goldenacre terrace	 tuesday-2	 friday-1
goldeneye drive	 wednesday-1	 thursday-2
goldeneye gait	 wednesday-1	 thursday-2
goodtrees gardens	 thursday-1	 friday-2
goodtrees terrace	 thursday-1	 friday-2
gordon loan	 friday-1	 friday-2
gordon road	 friday-1	 friday-2
gordon terrace	 thursday-2	 wednesday-2
gorgie road	None	 friday-2
gosford place	None	 thursday-2
gospatric gardens	None	 wednesday-1
gracemount avenue	 thursday-2	 wednesday-2
gracemount drive	 thursday-2	 wednesday-2
gracemount house drive	 thursday-2	 thursday-2
gracemount place	 thursday-2	 wednesday-2
gracemount road	 thursday-1	 wednesday-2
gracemount square	 thursday-2	 wednesday-2
granby road	None	 tuesday-1
grandison drive	 wednesday-1	 friday-1
grange crescent	 tuesday-2	 wednesday-1
grange loan gardens	 tuesday-2	 wednesday-1
grange road	 tuesday-2	 wednesday-1
grange terrace	 tuesday-2	 wednesday-1
grant avenue	 wednesday-2	 tuesday-2
granton crescent	 tuesday-2	 friday-2
granton gardens	 tuesday-2	 thursday-1
granton grove	 tuesday-2	 thursday-1
granton mains avenue	 tuesday-1	 tuesday-2
granton mains bank	 tuesday-1	 tuesday-2
granton mains brae	 tuesday-1	 tuesday-2
granton mains court	 tuesday-1	 tuesday-2
granton mains east	 tuesday-1	 tuesday-2
granton mains gait	 tuesday-1	 tuesday-2
granton mains vale	 tuesday-1	 tuesday-2
granton mains wynd	 tuesday-1	 tuesday-2
granton medway	 tuesday-2	 wednesday-1
granton mill crescent	 tuesday-1	 tuesday-2
granton mill drive	 tuesday-1	 tuesday-2
granton mill march	 tuesday-1	 friday-2
granton mill park	 tuesday-1	 tuesday-2
granton mill place	 tuesday-1	 tuesday-2
granton mill road	 tuesday-1	 tuesday-2
granton mill west	 tuesday-1	 tuesday-2
granton park avenue	 tuesday-2	 wednesday-1
granton park avenue north	 tuesday-2	 wednesday-1
granton place	 tuesday-1	 thursday-2
granton road	 tuesday-2	 wednesday-1
granton square	 tuesday-1	 wednesday-1
granton terrace	 tuesday-1	 thursday-2
granton view	 tuesday-2	 thursday-1
granville terrace	 tuesday-2	 tuesday-2
grassie avenue	 wednesday-1a	 thursday-1
gray's loan	 tuesday-2	 friday-1
great carleton place	 friday-1	 tuesday-2
great carleton square	 friday-1	 tuesday-2
great king street	 wednesday-1	 tuesday-2
great stuart street	 wednesday-1	 wednesday-1
greenbank avenue	 tuesday-1	 wednesday-2
greenbank crescent	 tuesday-1	 wednesday-1
greenbank drive	 tuesday-1	 wednesday-1
greenbank gardens	 tuesday-1	 wednesday-1
greenbank grove	 tuesday-1	 wednesday-1
greenbank lane	 tuesday-1	 wednesday-1
greenbank loan	 tuesday-1	 wednesday-1
greenbank park	 tuesday-1	 wednesday-1
greenbank place	 tuesday-1	 wednesday-2
greenbank rise	 tuesday-1	 wednesday-1
greenbank road	 tuesday-1	 wednesday-1
greenbank row	 tuesday-1	 wednesday-1
greencraig drive	 tuesday-1	 friday-2
greendale park	 tuesday-1	 thursday-2
greendykes road	 friday-1	 tuesday-2
greenend drive	 thursday-2	 friday-2
greenend gardens	 thursday-2	 friday-2
greenend grove	 thursday-2	 friday-2
greenfield crescent	 wednesday-1	 thursday-1
greenfield road	 wednesday-1	 thursday-1
greenhill gardens	 tuesday-2	 tuesday-2
greenhill park	 tuesday-2	 tuesday-2
greenhill place	 tuesday-2	 tuesday-2
greenhill terrace	 tuesday-2	 tuesday-2
greenlaw hedge	 tuesday-1	 wednesday-1
greenlaw rig	 tuesday-1	 tuesday-1
greenmantle loan	 thursday-2	 friday-1
greenpark	 thursday-2	 friday-2
greenstone loan	 thursday-1	 wednesday-2
greenwell wynd	 thursday-2	 wednesday-2
greenwood close	 friday-1	 thursday-2
gretna mews	 wednesday-1	 friday-1
grierson avenue	 tuesday-2	 thursday-1
grierson crescent	 tuesday-2	 thursday-1
grierson gardens	 tuesday-2	 thursday-1
grierson road	 tuesday-2	 thursday-1
grierson square	 tuesday-2	 thursday-1
grierson villas	 tuesday-2	 thursday-1
grieve crescent	 tuesday-1	 thursday-2
grigor avenue	 friday-2	 tuesday-2
grigor drive	 friday-2	 tuesday-2
grigor gardens	 friday-2	 tuesday-2
grigor terrace	 friday-2	 tuesday-2
groathill avenue	 friday-2	 tuesday-2
groathill gardens east	 friday-2	 tuesday-2
groathill gardens west	 friday-2	 tuesday-2
groathill loan	 friday-2	 friday-2
groathill road north	 friday-2	 friday-2
groathill road south	 friday-2	 tuesday-2
grosvenor crescent	 tuesday-1	 tuesday-1
grosvenor gardens	 tuesday-1	 tuesday-1
guardhouse parade	 wednesday-1	 friday-1
guardwell crescent	 thursday-1	 friday-2
guardwell glen	 thursday-1	 friday-2
gulliver street	 friday-1	 tuesday-2
gyle park gardens	 thursday-2	 friday-1
gylemuir road	 thursday-2	 wednesday-2
hadley terrace	 thursday-2	 thursday-2
hailes approach	 wednesday-1	 thursday-2
hailes avenue	 wednesday-1	 thursday-1
hailes bank	 wednesday-1	 thursday-2
hailes crescent	 wednesday-1	 thursday-1
hailes gardens	 wednesday-1	 thursday-2
hailes grove	 wednesday-1	 thursday-1
hailes park	 wednesday-1	 thursday-1
hailes street	 tuesday-2	 tuesday-2
hailes terrace	 wednesday-1	 thursday-1
hailesland gardens	 wednesday-2	 thursday-2
hailesland grove	 wednesday-2	 thursday-2
hailesland place	 wednesday-2	 thursday-2
hainburn park	 wednesday-2	 thursday-1
hall terrace	 friday-1	 wednesday-2
hallcroft close	 thursday-1	 wednesday-2
hallcroft crescent	 thursday-1	 wednesday-2
hallcroft gardens	 thursday-1	 wednesday-2
hallcroft green	 thursday-1	 wednesday-2
hallcroft neuk	 thursday-1	 wednesday-2
hallcroft park	 thursday-1	 wednesday-2
hallcroft rise	 thursday-1	 wednesday-2
hallhead road	 thursday-2	 wednesday-2
hallyards road	 thursday-1	 tuesday-1
hamilton drive	 friday-2	 thursday-2
hamilton drive west	 friday-2	 thursday-2
hamilton gardens	 friday-2	 thursday-2
hamilton grove	 friday-2	 thursday-2
hamilton park	 friday-2	 thursday-2
hamilton place	None	 tuesday-2
hamilton terrace	 friday-2	 thursday-2
hamilton's folly mews	 friday-1	 wednesday-2
hammond place	 friday-1	 tuesday-2
hampton place	 tuesday-2	 tuesday-1
hampton terrace	 tuesday-2	 tuesday-1
hapland bow	 thursday-2	 wednesday-2
harbour place	 friday-1	 friday-2
harden place	 tuesday-2	 friday-1
harelaw road	 wednesday-2	 tuesday-2
harewood crescent	 friday-1	 tuesday-2
harlaw bank	 wednesday-1	 friday-1
harlaw gait	 wednesday-1	 friday-1
harlaw march	 wednesday-1	 friday-1
harlaw road	 wednesday-1	 friday-1
harrison gardens	None	 friday-1
harrison road	 tuesday-2	 friday-1
hartington gardens	 tuesday-1	 wednesday-1
hartington place	 tuesday-2	 wednesday-1
harvest road	 thursday-1	 wednesday-2
harvest wynd	 thursday-1	 wednesday-2
hatton place	 tuesday-2	 wednesday-1
havenfield mews	 friday-1	 wednesday-1
hawkhead crescent	 thursday-2	 thursday-2
hawkhead grove	 thursday-2	 thursday-2
hawkhill	 wednesday-1	 wednesday-1
hawkhill avenue	 wednesday-1	 wednesday-1
hawthornbank place	 wednesday-1	 thursday-2
hawthornbank terrace	 wednesday-1	 thursday-2
hawthornvale	None	 tuesday-1
hay avenue	 friday-1	 tuesday-2
hay drive	 friday-1	 tuesday-2
hay gardens	 friday-1	 tuesday-2
hay place	 friday-1	 tuesday-2
hay terrace	 friday-1	 tuesday-2
hayfield	 thursday-2	 friday-2
haystack park	 thursday-2	 friday-1
hazelbank terrace	 tuesday-1	 wednesday-1
hazeldean terrace	 friday-1	 friday-1
hazelwood grove	 friday-1	 friday-1
headrigg row	 friday-1	 friday-1
hedgehog crescent	 wednesday-1	 thursday-2
hedgehog walk	 wednesday-1	 thursday-2
helen crummy way	 wednesday-1a	 thursday-1
henderland road	 friday-2	 tuesday-1
henderson row	 wednesday-1	 tuesday-2
henderson terrace	 tuesday-2	 friday-1
henry ross place	 thursday-1	 wednesday-1
hepburn crescent	 thursday-2	 wednesday-2
herdrigg place	 thursday-2	 wednesday-2
heriot row	 wednesday-1	 tuesday-2
hermand crescent	None	 friday-2
hermiston	 thursday-1	 friday-1
hermiston house road	None	 friday-2
hermiston steading	 thursday-1	 friday-1
hermitage drive	 tuesday-1	 wednesday-2
hermitage gardens	 tuesday-1	 wednesday-2
hermitage park	 wednesday-1	 thursday-2
hermitage park grove	 wednesday-1	 wednesday-1
hermitage park south	 wednesday-1	 thursday-2
hermitage place	 wednesday-1	 wednesday-1
hermitage terrace	 tuesday-2	 wednesday-2
hermits croft	 friday-1	 wednesday-2
hewing place	 wednesday-1a	 thursday-1
hewlett way	 thursday-1	 tuesday-2
hewson way	 friday-1	 tuesday-2
high buckstone	 tuesday-1	 friday-2
high street	None	 thursday-1
highlea circle	 wednesday-1	 thursday-1
highlea grove	 wednesday-1	 thursday-1
hillcoat loan	 friday-2	 tuesday-2
hillpark avenue	 friday-2	 friday-1
hillpark brae	 friday-2	 friday-1
hillpark court	 friday-2	 friday-1
hillpark crescent	 friday-2	 friday-1
hillpark drive	 friday-2	 friday-1
hillpark gardens	 friday-2	 friday-1
hillpark green	 friday-2	 friday-1
hillpark grove	 friday-2	 friday-1
hillpark loan	 friday-2	 friday-1
hillpark rise	 friday-2	 friday-1
hillpark road	 friday-2	 friday-1
hillpark terrace	 friday-2	 friday-1
hillpark way	 friday-2	 friday-1
hillpark wood	 friday-2	 friday-1
hillside crescent	None	 thursday-1
hillside street	None	 thursday-1
hillview	 friday-2	 wednesday-2
hillview cottages	 thursday-1	 wednesday-2
hillview crescent	 friday-1	 wednesday-2
hillview drive	 friday-1	 wednesday-2
hillview road	 friday-1	 wednesday-2
hillview terrace	 friday-1	 wednesday-2
hillwood avenue	 thursday-1	 wednesday-2
hillwood crescent	 thursday-1	 wednesday-2
hillwood gardens	 thursday-1	 wednesday-2
hillwood rise	 thursday-1	 wednesday-2
hillwood road	 thursday-1	 wednesday-2
hillwood terrace	 thursday-1	 wednesday-2
hoffmann place	 friday-1	 thursday-1
hollybank terrace	 tuesday-1	 wednesday-1
holyrood park road	 friday-1	 wednesday-2
hope lane	 friday-2	 wednesday-1
hope lane north	 friday-1	 friday-2
hope street	None	 wednesday-1
hope terrace	 tuesday-2	 tuesday-2
hopefield terrace	 wednesday-1	 thursday-2
hopetoun road	 thursday-1	 wednesday-1
hopper gardens	 wednesday-1a	 thursday-1
horsburgh bank	 wednesday-1	 friday-1
horsburgh gardens	 wednesday-1	 friday-1
horsburgh grove	 wednesday-1	 friday-1
hoseason gardens	 friday-1	 thursday-2
hosie rigg	 friday-1	 thursday-1
house o'hill avenue	 friday-2	 wednesday-2
house o'hill brae	 friday-2	 wednesday-2
house o'hill crescent	 friday-2	 wednesday-2
house o'hill gardens	 friday-2	 wednesday-2
house o'hill green	 friday-2	 wednesday-2
house o'hill grove	 friday-2	 wednesday-2
house o'hill place	 friday-2	 wednesday-2
house o'hill road	 friday-2	 wednesday-2
house o'hill row	 friday-2	 wednesday-2
house o'hill terrace	 friday-2	 wednesday-2
housefield drive	 thursday-1	 tuesday-2
howard place	 tuesday-2	 friday-1
howden hall court	 thursday-2	 wednesday-2
howden hall crescent	 thursday-2	 wednesday-2
howden hall drive	 thursday-2	 wednesday-2
howden hall gardens	 thursday-2	 wednesday-2
howden hall loan	 thursday-2	 wednesday-2
howden hall park	 thursday-2	 wednesday-2
howden hall road	None	 wednesday-2
howden hall way	 thursday-2	 wednesday-2
howe park	 wednesday-2	 thursday-1
howe street	 wednesday-1	 tuesday-2
hugh miller place	 tuesday-1	 tuesday-2
hugh russell place	 thursday-1	 wednesday-1
humbie farm road	 thursday-1	 tuesday-1
humbie road	 thursday-1	 thursday-1
hutchison avenue	 tuesday-2	 friday-2
hutchison cottages	 tuesday-2	 friday-2
hutchison crossway	 tuesday-2	 friday-2
hutchison gardens	 tuesday-2	 wednesday-1
hutchison grove	 tuesday-2	 wednesday-1
hutchison loan	 tuesday-2	 wednesday-1
hutchison medway	 tuesday-2	 wednesday-1
hutchison park	 tuesday-2	 friday-2
hutchison place	 tuesday-2	 friday-2
hutchison road	 tuesday-2	 friday-2
hutchison terrace	 tuesday-2	 friday-2
hutchison view	 tuesday-2	 friday-2
hyvot avenue	 thursday-1	 friday-2
hyvot bank avenue	 thursday-1	 friday-2
hyvot court	 thursday-1	 friday-2
hyvot gardens	 thursday-1	 friday-2
hyvot green	 thursday-1	 friday-2
hyvot grove	 thursday-1	 friday-2
hyvot loan	 thursday-1	 friday-2
hyvot mill drive	 thursday-1	 friday-2
hyvot mill road	 thursday-1	 friday-2
hyvot park	 thursday-1	 friday-2
hyvot terrace	 thursday-1	 friday-2
hyvot view	 thursday-1	 friday-2
inchcolm terrace	 thursday-1	 wednesday-1
inchgarvie park	 thursday-1	 tuesday-1
inchkeith avenue	 thursday-1	 wednesday-1
inchview terrace	 wednesday-2	 tuesday-2
india place	None	 thursday-2
india street	 wednesday-1	 tuesday-2
industry home	 wednesday-1	 friday-1
industry lane	 wednesday-1	 friday-1
inglis green road	 tuesday-2	 wednesday-2
inveralmond drive	 friday-1	 wednesday-1
inveralmond gardens	 friday-1	 wednesday-1
inveralmond grove	 friday-1	 wednesday-1
inverleith avenue	 tuesday-2	 friday-1
inverleith avenue south	 tuesday-2	 friday-1
inverleith gardens	 tuesday-2	 friday-1
inverleith grove	 tuesday-2	 friday-1
inverleith place	 tuesday-2	 friday-1
inverleith place lane	 tuesday-2	 tuesday-2
inverleith row	 tuesday-2	 friday-1
inverleith terrace	 tuesday-2	 friday-1
iona street	None	 thursday-1
ivanhoe crescent	 thursday-2	 wednesday-2
ivy terrace	 tuesday-1	 wednesday-1
jamaica street south lane	 wednesday-1	 tuesday-2
james street	 friday-2	 tuesday-1
janefield	 thursday-1	 wednesday-2
jansch place	 tuesday-1	 friday-2
jardine place	 friday-1	 thursday-1
jeffrey avenue	 friday-2	 wednesday-2
jessfield terrace	 wednesday-1	 thursday-2
john mason court	 thursday-1	 wednesday-1
john paul jones view	None	 friday-1
john street	 friday-2	 tuesday-1
john's place	 wednesday-1	 wednesday-1
johnsburn green	 wednesday-1	 thursday-1
johnsburn haugh	 wednesday-1	 thursday-1
johnsburn park	 wednesday-1	 thursday-1
johnsburn road	 wednesday-1	 thursday-1
joppa gardens	 friday-2	 tuesday-1
joppa grove	 friday-2	 tuesday-1
joppa pans	 friday-2	 tuesday-1
joppa park	 friday-1	 friday-2
joppa road	 friday-2	 tuesday-1
joppa station place	 friday-2	 tuesday-1
joppa terrace	 friday-2	 tuesday-1
jordan lane	 tuesday-1	 wednesday-2
juniper avenue	 wednesday-1	 tuesday-1
juniper gardens	 wednesday-1	 friday-1
juniper grove	 wednesday-1	 friday-1
juniper lane	 wednesday-1	 tuesday-1
juniper park road	 thursday-1	 friday-1
juniper place	 wednesday-1	 tuesday-1
juniper terrace	 wednesday-1	 tuesday-1
juniperlee	 wednesday-1	 friday-1
kaimes road	 friday-1	 friday-2
kane wynd	 friday-1	 tuesday-2
katesmill road	 wednesday-1	 thursday-1
kedslie place	 thursday-2	 wednesday-2
kedslie road	 thursday-2	 wednesday-2
keith crescent	 friday-2	 wednesday-2
keith row	 friday-2	 wednesday-2
keith terrace	 friday-1	 thursday-1
kekewich avenue	 wednesday-2	 tuesday-2
kemp place	 tuesday-1	 tuesday-2
kempsel grove	 thursday-2	 thursday-2
kempston place	 thursday-1	 wednesday-1
kenilworth drive	 thursday-2	 friday-1
kenmure avenue	 wednesday-2	 wednesday-2
kew terrace	 tuesday-2	 tuesday-1
kidlaw close	 thursday-2	 thursday-2
kilchurn court	 thursday-2	 friday-2
kilgours bow	 wednesday-1a	 thursday-1
kilgraston road	 tuesday-2	 wednesday-1
killiekrankies path	 thursday-1	 tuesday-2
kilmaurs road	 friday-1	 thursday-1
kilmaurs terrace	 friday-1	 thursday-1
kilmorey place	 thursday-1	 tuesday-2
kilngate brae	 thursday-1	 friday-2
kimmerghame loan	 tuesday-1	 tuesday-2
kimmerghame place	 tuesday-1	 tuesday-2
kimmerghame row	 tuesday-1	 tuesday-2
kimmerghame view	 tuesday-1	 tuesday-2
kinellan gardens	 friday-1	 tuesday-1
kinellan road	 friday-2	 tuesday-1
king edward's way	 thursday-1	 thursday-1
king malcolm close	 tuesday-1	 tuesday-1
king's cramond	 friday-1	 wednesday-1
king's meadow	 friday-1	 thursday-1
king's road	 friday-2	 tuesday-2
kinghorn place	 tuesday-1	 thursday-2
kings view close	None	 wednesday-2
kings view crescent	 thursday-1	 wednesday-2
kingsburgh road	 friday-2	 tuesday-1
kingsknowe avenue	 tuesday-2	 thursday-2
kingsknowe crescent	 tuesday-2	 thursday-2
kingsknowe drive	 tuesday-2	 thursday-2
kingsknowe gardens	 tuesday-2	 thursday-2
kingsknowe grove	 tuesday-2	 thursday-2
kingsknowe place	 wednesday-2	 wednesday-2
kingsknowe road north	 wednesday-2	 wednesday-2
kingsknowe road south	 tuesday-2	 thursday-2
kingsknowe terrace	 tuesday-2	 thursday-2
kingston avenue	 friday-1	 friday-1
kinleith mill road	 wednesday-1	 tuesday-1
kinloch road	 thursday-1	 friday-2
kinnear rise	 tuesday-2	 friday-1
kinnear road	 tuesday-2	 friday-1
kirk loan	 friday-1	 thursday-1
kirk park	 thursday-2	 thursday-2
kirk street	None	 thursday-2
kirkhill drive	 friday-1	 thursday-1
kirkhill gardens	 friday-1	 thursday-1
kirkhill road	 friday-1	 thursday-1
kirkhill terrace	 friday-1	 thursday-1
kirklands	 friday-1	 tuesday-2
kirklands park crescent	 thursday-1	 thursday-1
kirklands park gardens	 thursday-1	 thursday-1
kirklands park grove	 thursday-1	 thursday-1
kirklands park rigg	 thursday-1	 thursday-1
kirklands park street	 thursday-1	 thursday-1
kirkliston road	 thursday-1	 wednesday-1
kirkstyle gardens	 thursday-1	 thursday-1
kisimul court	 thursday-2	 friday-2
klondyke street	 wednesday-1a	 thursday-1
knight crescent	 friday-1	 tuesday-2
ladehead	 wednesday-1	 friday-1
ladiemeadow	 friday-1	 tuesday-2
lady menzies place	None	 thursday-1
lady nairne crescent	 wednesday-2	 thursday-2
lady nairne grove	 wednesday-2	 thursday-2
lady nairne loan	 wednesday-2	 thursday-2
lady nairne place	 wednesday-2	 thursday-2
lady road	 thursday-2	 tuesday-1
ladycroft	 wednesday-1	 thursday-1
ladysmith road	 tuesday-2	 tuesday-2
ladywell avenue	 friday-1	 tuesday-2
ladywell gardens	 friday-1	 tuesday-2
ladywell road	 friday-1	 wednesday-2
laichfield	 tuesday-2	 friday-2
laichpark loan	 tuesday-2	 friday-2
laichpark place	 tuesday-2	 friday-2
laichpark road	 tuesday-2	 friday-2
laing terrace	None	 tuesday-1
lambsmiln place	 thursday-1	 tuesday-2
lammermoor terrace	 friday-1	 friday-1
lamont place	 thursday-2	 wednesday-2
lampacre road	 friday-1	 thursday-1
lang rigg	 thursday-1	 tuesday-1
langton road	 tuesday-2	 tuesday-2
langwill place	 wednesday-1	 friday-2
lansdowne crescent	 tuesday-1	 tuesday-1
larchfield	 wednesday-1	 thursday-1
larchfield neuk	 wednesday-1	 thursday-1
larchwood square	 friday-1	 thursday-2
larkfield gardens	 tuesday-2	 wednesday-1
lasswade bank	 thursday-1	 wednesday-2
lasswade grove	 thursday-1	 wednesday-2
latch park	 wednesday-2	 friday-1
lauder loan	 tuesday-2	 wednesday-1
lauder road	 tuesday-2	 wednesday-1
lauderdale street	None	 wednesday-1
laurel terrace	 tuesday-1	 friday-1
lauriston farm road	 tuesday-1	 thursday-1
lauriston gardens	 tuesday-2	 tuesday-2
lauriston place	 tuesday-2	 tuesday-2
lauson place	 thursday-1	 tuesday-2
laverockbank avenue	 tuesday-2	 tuesday-1
laverockbank crescent	 tuesday-2	 tuesday-1
laverockbank gardens	 tuesday-2	 tuesday-1
laverockbank grove	 tuesday-2	 tuesday-1
laverockbank road	 tuesday-2	 tuesday-1
laverockbank terrace	 tuesday-2	 tuesday-1
laverockdale crescent	 wednesday-2	 tuesday-2
laverockdale loan	 wednesday-2	 tuesday-2
laverockdale park	 wednesday-2	 tuesday-2
law place	 friday-1	 friday-2
lawson crescent	 thursday-1	 wednesday-1
leadervale road	 thursday-2	 wednesday-2
leadervale terrace	 thursday-2	 wednesday-2
leamington terrace	 tuesday-2	 tuesday-2
learmonth avenue	 tuesday-1	 thursday-2
learmonth crescent	 tuesday-1	 thursday-2
learmonth gardens	 tuesday-1	 thursday-2
learmonth grove	 tuesday-2	 thursday-2
learmonth park	 tuesday-1	 thursday-2
learmonth place	 tuesday-2	 thursday-2
learmonth terrace	 tuesday-1	 thursday-2
lee crescent	 friday-2	 wednesday-1
lennel avenue	 friday-2	 tuesday-1
lennie cottages	 thursday-2	 friday-2
lennox street	 tuesday-1	 thursday-2
lennymuir	 thursday-2	 friday-2
lerbar way	 thursday-2	 thursday-2
leslie place	 tuesday-1	 thursday-2
leven close	None	 tuesday-2
leven terrace	None	 tuesday-2
lewis terrace	 tuesday-1	 wednesday-1
liberton gardens	 thursday-2	 thursday-2
liberton place	 thursday-2	 thursday-2
liberton tower lane	 thursday-2	 wednesday-2
lidgate shot	 thursday-1	 wednesday-2
lily terrace	 tuesday-2	 friday-1
lilyhill terrace	 wednesday-2	 thursday-2
lime kilns view	 thursday-1	 thursday-2
limefield	 thursday-1	 friday-2
lindean place	 wednesday-1	 thursday-2
linden avenue	 thursday-2	 wednesday-2
lindsay road	None	 friday-1
lingerwood lane	 friday-1	 tuesday-2
links gardens	None	 wednesday-1
linn mill	 thursday-1	 tuesday-1
lismore avenue	 wednesday-2	 thursday-2
lismore crescent	 wednesday-2	 thursday-2
liston drive	 thursday-1	 thursday-1
liston place	 thursday-1	 thursday-1
liston road	 thursday-1	 thursday-1
little france mills	 thursday-1	 tuesday-2
little road	 thursday-2	 thursday-2
little street	 thursday-1	 wednesday-1
littlejohn avenue	 tuesday-1	 tuesday-1
littlejohn road	 tuesday-1	 tuesday-1
littlejohn wynd	 tuesday-1	 tuesday-1
livingstone place	 tuesday-1	 wednesday-1
lixmount avenue	 tuesday-2	 tuesday-1
lixmount gardens	 tuesday-2	 tuesday-1
loaning road	 wednesday-2	 tuesday-1
loch place	 thursday-1	 wednesday-1
lochend avenue	 wednesday-1	 wednesday-1
lochend castle barns	 wednesday-2	 thursday-1
lochend crescent	 wednesday-2	 thursday-1
lochend drive	 wednesday-2	 thursday-1
lochend gardens	 wednesday-2	 thursday-1
lochend grove	 wednesday-1	 thursday-1
lochend park	 wednesday-1	 wednesday-1
lochend quadrant	 wednesday-1	 thursday-1
lochend road south	 wednesday-2	 thursday-1
lochend square	 wednesday-1	 wednesday-1
lochiel crossway	 thursday-2	 wednesday-2
lockerby cottages	 thursday-1a	 wednesday-2
lockerby crescent	 thursday-1	 wednesday-2
lockerby grove	 thursday-1	 wednesday-2
lockharton avenue	 wednesday-2	 tuesday-1
lockharton crescent	 wednesday-2	 tuesday-1
lockharton gardens	 wednesday-2	 tuesday-1
logan street	 wednesday-1	 tuesday-2
loganlea avenue	 wednesday-2	 tuesday-1
loganlea drive	 wednesday-2	 tuesday-1
loganlea gardens	 wednesday-1	 friday-2
loganlea loan	 wednesday-2	 tuesday-1
loganlea place	 wednesday-2	 tuesday-1
loganlea road	 wednesday-2	 tuesday-1
loganlea terrace	 wednesday-2	 tuesday-1
logie green gardens	 wednesday-1	 friday-1
logie green loan	 wednesday-1	 friday-1
logie green road	 wednesday-1	 friday-1
lomond road	 tuesday-2	 wednesday-1
london street	 wednesday-1	 tuesday-2
long crook	 thursday-1	 tuesday-1
long dalmahoy road	 wednesday-1	 friday-1
longformacus road	 thursday-2	 thursday-2
longstone avenue	 wednesday-2	 wednesday-2
longstone cottages	 wednesday-2	 wednesday-2
longstone crescent	 wednesday-2	 thursday-1
longstone gardens	 wednesday-2	 wednesday-2
longstone grove	 wednesday-2	 wednesday-2
longstone road	 wednesday-2	 wednesday-2
longstone street	 wednesday-2	 wednesday-2
longstone terrace	 wednesday-2	 wednesday-2
longstone view	 wednesday-2	 wednesday-2
longwall crescent	 wednesday-1a	 thursday-1
lonsdale terrace	None	 wednesday-1
lorne place	None	 thursday-1
lorne street	 wednesday-1	 thursday-1
lovedale avenue	 wednesday-1	 thursday-1
lovedale crescent	 wednesday-1	 thursday-1
lovedale gardens	 wednesday-1	 thursday-1
lovedale grove	 wednesday-1	 thursday-1
lovedale road	 wednesday-1	 thursday-1
lower granton road	 tuesday-2	 wednesday-1
lower joppa	 friday-2	 tuesday-1
lower london road	 wednesday-2	 thursday-1
lowrie gait	 thursday-1	 tuesday-2
lucas gardens	 wednesday-1	 tuesday-1
lugton circle	 wednesday-1	 friday-2
lugton terrace	 wednesday-1	 friday-2
lumsden court	 thursday-1	 wednesday-2
lumsden square	 wednesday-1	 friday-2
lumsden wynd	 wednesday-1	 friday-2
lurie place	 friday-1	 tuesday-2
lussielaw road	 tuesday-2	 tuesday-1
lutton place	 wednesday-1	 thursday-1
lyall bow	 wednesday-1	 friday-1
lygon road	 thursday-2	 tuesday-1
lynedoch place	 tuesday-1	 wednesday-1
macdowall road	 tuesday-2	 tuesday-1
macfie loan	 wednesday-2	 tuesday-2
macgill drive	 tuesday-1	 thursday-2
mackinnon crescent	 thursday-1	 tuesday-2
macmath gait	 thursday-2	 wednesday-2
madeira place	 wednesday-1	 friday-1
madeira street	None	 friday-1
magdala crescent	 tuesday-2	 tuesday-1
magdala mews	 tuesday-2	 tuesday-1
magdalene avenue	 friday-2	 wednesday-1
magdalene court	 friday-2	 thursday-1
magdalene gardens	 friday-2	 thursday-1
magdalene loan	 friday-2	 thursday-1
magdalene medway	 friday-2	 thursday-1
magdalene place	 friday-2	 thursday-1
maidencraig court	None	 wednesday-2
maidencraig crescent	 friday-2	 wednesday-2
maidencraig grove	 friday-2	 wednesday-2
maingait medway	 wednesday-1a	 thursday-1
mains of craigmillar	 friday-1	 tuesday-2
maitland hog lane	 thursday-1	 thursday-1
maitland road	 thursday-1	 thursday-1
malachi close	 thursday-1	 thursday-1
malachi gait	 thursday-1	 thursday-1
malachi green	 thursday-1	 thursday-1
malachi rigg	 thursday-1	 thursday-1
malbet park	 thursday-2	 thursday-2
malbet wynd	 thursday-2	 thursday-2
malleny avenue	 wednesday-1	 thursday-1
malleny millgate	 wednesday-1	 friday-1
maltman street	 friday-1	 wednesday-2
mannering place	 thursday-2	 friday-1
manor place	 tuesday-1	 tuesday-1
manse street	 friday-1	 thursday-1
mansfield place	 wednesday-1	 tuesday-2
mansionhouse road	 tuesday-2	 wednesday-1
maplewood park	 friday-1	 thursday-2
march gait	 friday-2	 friday-1
march grove	 friday-2	 friday-1
march pines	 friday-2	 friday-1
march road	 friday-2	 friday-1
marchbank drive	 wednesday-1	 thursday-1
marchbank gardens	 wednesday-1	 thursday-1
marchbank grove	 wednesday-1	 thursday-1
marchbank place	 wednesday-1	 thursday-1
marchbank way	 wednesday-1	 thursday-1
marchfield grove	 friday-2	 wednesday-2
marchfield park	 friday-2	 wednesday-2
marchfield park lane	 friday-2	 wednesday-2
marchfield terrace	 friday-2	 friday-1
marchhall crescent	 friday-1	 thursday-1
marchhall road	 friday-1	 thursday-1
marchmont crescent	None	 wednesday-1
marchmont road	None	 wednesday-1
marchmont street	None	 wednesday-1
marden place	 thursday-2	 wednesday-2
margaret rose avenue	 tuesday-1	 tuesday-1
margaret rose crescent	 tuesday-1	 tuesday-1
margaret rose drive	 tuesday-1	 tuesday-1
margaret rose loan	 tuesday-1	 tuesday-1
margaret rose walk	 tuesday-1	 tuesday-1
margaret rose way	 tuesday-1	 tuesday-1
marine drive	 tuesday-1	 tuesday-2
marionville avenue	 wednesday-2	 tuesday-1
marionville crescent	 wednesday-2	 tuesday-1
marionville drive	 wednesday-2	 tuesday-1
marionville grove	 wednesday-2	 tuesday-1
marionville park	 wednesday-2	 tuesday-1
marischal place	None	 wednesday-2
marlborough street	 friday-1	 friday-2
marmion crescent	 friday-1	 friday-1
marrow street	 tuesday-1	 thursday-2
marshall road	 thursday-1	 thursday-1
martin street	 thursday-1	 thursday-2
mary's place	None	 thursday-2
maryfield	None	 thursday-1
masson close	 thursday-1	 thursday-1
matthew street	None	 tuesday-2
maude close	 thursday-1	 thursday-1
maude park	 thursday-1	 thursday-1
maude place	 thursday-1	 thursday-1
maurice place	 tuesday-2	 tuesday-2
maxwell street	 tuesday-1	 thursday-1
mayall road	 tuesday-1	 thursday-2
maybank villas	 friday-1	 friday-2
maybury drive	 thursday-2	 friday-2
mayfield terrace	 wednesday-1	 thursday-1
mayville gardens	 tuesday-2	 tuesday-1
mayville gardens east	 tuesday-2	 tuesday-1
mcarthur rigg	 thursday-1	 tuesday-2
mccartney road	 wednesday-1a	 thursday-1
mcdonald place	 wednesday-1	 thursday-1
mcdonald road	 wednesday-1	 thursday-1
mclaren road	 wednesday-1	 thursday-1
mclaren terrace	 tuesday-1	 wednesday-1
meadow place	None	 wednesday-1
meadow place road	 friday-1	 wednesday-2
meadowbank crescent	None	 thursday-2
meadowbank terrace	None	 thursday-2
meadowfield avenue	 wednesday-2	 thursday-2
meadowfield drive	 wednesday-2	 thursday-2
meadowfield gardens	 wednesday-2	 thursday-2
meadowfield terrace	 wednesday-2	 thursday-2
meadowhouse road	 friday-1	 thursday-1
meadowspot	 tuesday-1	 thursday-1
meadowsweet drive	 thursday-2	 friday-2
mearenside	 thursday-2	 friday-2
meggetland terrace	 tuesday-1	 wednesday-2
melville terrace	 tuesday-1	 wednesday-1
mentone avenue	 friday-1	 friday-2
mentone gardens	 tuesday-2	 tuesday-1
mentone terrace	 tuesday-2	 wednesday-2
merchiston avenue	 tuesday-2	 tuesday-2
merchiston bank avenue	 tuesday-2	 tuesday-2
merchiston bank gardens	 tuesday-2	 friday-1
merchiston crescent	 tuesday-2	 tuesday-2
merchiston gardens	 tuesday-2	 friday-1
merchiston mews	 tuesday-1	 wednesday-1
merchiston park	 tuesday-2	 tuesday-2
merchiston place	 tuesday-2	 tuesday-2
mertoun place	None	 friday-1
mid gillsland road	 tuesday-2	 friday-1
mid gogarloch syke	 thursday-2	 friday-1
mid liberton	 thursday-2	 wednesday-2
mid steil	 tuesday-1	 tuesday-1
mid terrace	 thursday-1	 tuesday-1
middle norton	 thursday-1	 wednesday-2
middleby street	 tuesday-2	 tuesday-1
middleknowe	 wednesday-1	 wednesday-2
middlepark	 wednesday-1	 wednesday-2
middleshot	 wednesday-1	 wednesday-2
midmar avenue	 tuesday-1	 wednesday-2
midmar drive	 tuesday-1	 wednesday-2
midmar gardens	 tuesday-1	 wednesday-2
millar crescent	 tuesday-1	 friday-1
millar place lane	 tuesday-1	 wednesday-2
millbank	 wednesday-1	 friday-1
milligan drive	 friday-1	 tuesday-2
milligan road	 friday-1	 tuesday-2
milnacre	 wednesday-1	 friday-1
milton crescent	 friday-2	 friday-2
milton drive	 friday-2	 tuesday-1
milton farm road	 thursday-1	 wednesday-1
milton gardens north	 friday-2	 friday-2
milton gardens south	 friday-2	 friday-2
milton road	 friday-2	 wednesday-1
milton road west	 friday-2	 friday-2
milton street	None	 thursday-1
milton terrace	 friday-2	 tuesday-1
mitchell street	 wednesday-1	 wednesday-1
moat drive	 tuesday-2	 friday-2
moat place	 tuesday-2	 friday-2
moat street	 tuesday-2	 friday-2
moat terrace	 tuesday-2	 friday-2
moffat way	 friday-1	 tuesday-2
moira park	 wednesday-2	 tuesday-2
moira terrace	 wednesday-2	 tuesday-2
moira terrace lane	 wednesday-1	 friday-2
moncrieff terrace	 tuesday-1	 wednesday-1
monkbarns gardens	 thursday-2	 friday-1
monmouth terrace	None	 friday-1
montagu terrace	 tuesday-2	 friday-1
montague street	None	 wednesday-2
montgomery street	 wednesday-2	 thursday-1
montpelier park	None	 tuesday-2
montpelier terrace	None	 tuesday-2
montrose terrace	None	 thursday-1
moodie place	 wednesday-1	 friday-2
moray place	 wednesday-1	 tuesday-2
moredun dell	 thursday-1	 friday-2
moredun dykes road	 thursday-1	 friday-2
moredun park court	 thursday-1	 friday-2
moredun park drive	 thursday-1	 friday-2
moredun park gardens	 thursday-1	 friday-2
moredun park green	 thursday-1	 friday-2
moredun park grove	 thursday-1	 friday-2
moredun park loan	 thursday-1	 friday-2
moredun park road	 thursday-1	 friday-1
moredun park street	 thursday-1	 friday-2
moredun park view	 thursday-1	 friday-2
moredun park way	 thursday-1	 friday-2
moredunvale green	 thursday-1	 friday-2
moredunvale grove	 thursday-1	 friday-2
moredunvale loan	 thursday-1	 friday-2
moredunvale park	 thursday-1	 friday-2
moredunvale place	 thursday-1	 friday-2
moredunvale road	 thursday-1	 tuesday-2
moredunvale view	 thursday-1	 friday-2
moredunvale way	 thursday-1	 friday-2
morham gait	 tuesday-1	 tuesday-1
morham gardens	 tuesday-1	 tuesday-1
morham lea	 tuesday-1	 tuesday-1
morham park	 tuesday-1	 tuesday-1
morison gardens	 thursday-1	 wednesday-1
morningside drive	 tuesday-1	 thursday-1
morningside gardens	 tuesday-1	 thursday-1
morningside grove	 tuesday-1	 thursday-1
morningside park	 tuesday-2	 friday-1
morningside place	 tuesday-2	 friday-1
morningside road	 tuesday-2	 tuesday-2
morningside terrace	 tuesday-1	 friday-1
mortonhall park avenue	 thursday-2	 wednesday-2
mortonhall park bank	 thursday-2	 wednesday-2
mortonhall park crescent	 thursday-2	 wednesday-2
mortonhall park drive	 thursday-2	 wednesday-2
mortonhall park gardens	 thursday-2	 wednesday-2
mortonhall park green	 thursday-2	 wednesday-2
mortonhall park grove	 thursday-2	 wednesday-2
mortonhall park loan	 thursday-2	 wednesday-2
mortonhall park place	None	 wednesday-2
mortonhall park terrace	 thursday-2	 wednesday-2
mortonhall park view	 thursday-2	 wednesday-2
mortonhall park way	 thursday-2	 wednesday-2
mortonhall road	 tuesday-2	 tuesday-2
morven street	 friday-1	 thursday-2
morvenside	 wednesday-1	 wednesday-2
mossgiel walk	None	 friday-1
moston terrace	 tuesday-2	 wednesday-2
mottram road	 tuesday-1	 thursday-2
moubray grove	 thursday-1	 tuesday-2
mount lodge place	 friday-1	 friday-2
mountcastle bank	 friday-2	 thursday-2
mountcastle crescent	 friday-2	 wednesday-2
mountcastle drive south	 friday-2	 friday-2
mountcastle gardens	 friday-2	 wednesday-2
mountcastle green	 friday-2	 tuesday-1
mountcastle grove	 friday-2	 wednesday-2
mountcastle loan	 friday-2	 thursday-2
mountcastle park	 friday-1	 wednesday-2
mountcastle place	 friday-2	 tuesday-1
mountcastle terrace	 friday-2	 wednesday-2
mounthooly loan	 tuesday-1	 tuesday-1
muir wood crescent	 wednesday-1	 tuesday-1
muir wood drive	 wednesday-1	 tuesday-1
muir wood grove	 wednesday-1	 tuesday-1
muir wood place	 wednesday-1	 tuesday-1
muir wood road	 wednesday-1	 tuesday-1
muirdale terrace	 friday-2	 wednesday-2
muirend avenue	 tuesday-2	 thursday-2
muirhouse avenue	 tuesday-1	 thursday-2
muirhouse bank	 tuesday-1	 thursday-2
muirhouse close	 tuesday-1	 thursday-2
muirhouse drive	 tuesday-1	 thursday-2
muirhouse gardens	 tuesday-1	 thursday-2
muirhouse green	 tuesday-1	 thursday-2
muirhouse grove	None	 thursday-2
muirhouse loan	 tuesday-1	 thursday-2
muirhouse medway	 tuesday-1	 thursday-2
muirhouse park	 tuesday-1	 thursday-2
muirhouse parkway	 tuesday-1	 thursday-2
muirhouse place east	 tuesday-1	 thursday-2
muirhouse place west	 tuesday-1	 thursday-2
muirhouse terrace	 tuesday-1	 thursday-2
mulberry place	None	 friday-1
munro drive	 wednesday-2	 tuesday-2
murieston crescent	None	 wednesday-1
murray cottages	 friday-1	 wednesday-2
murrayburn drive	 wednesday-2	 thursday-2
murrayburn gardens	 wednesday-2	 thursday-2
murrayburn grove	 wednesday-2	 thursday-2
murrayburn park	 wednesday-2	 thursday-2
murrayburn place	None	 thursday-2
murrayfield avenue	 friday-2	 tuesday-1
murrayfield drive	 friday-2	 tuesday-1
murrayfield gardens	 friday-2	 tuesday-1
murrayfield place	 friday-1	 tuesday-1
murrayfield road	 friday-2	 tuesday-1
myreside road	 tuesday-1	 friday-1
myrtle terrace	 tuesday-1	 wednesday-1
nantwich drive	 wednesday-2	 tuesday-2
napier loan	 tuesday-1	 wednesday-1
napier road	 tuesday-2	 friday-1
nealands road	 friday-1	 tuesday-2
neidpath court	 thursday-2	 friday-2
nellfield	 thursday-2	 friday-1
nelson place	 wednesday-1	 tuesday-2
nelson street	 wednesday-1	 tuesday-2
nether craigour	 thursday-1	 tuesday-2
nether currie crescent	 wednesday-1	 tuesday-1
nether currie place	 wednesday-1	 tuesday-1
nether currie road	 wednesday-1	 tuesday-1
netherbank	 thursday-2	 wednesday-2
netherbank view	 thursday-2	 wednesday-2
netherby road	 tuesday-2	 wednesday-1
new lairdship place	 thursday-2	 thursday-2
new mart square	 tuesday-2	 friday-2
new swanston	 wednesday-2	 thursday-1
new tower place	 friday-1	 friday-2
newbattle terrace	 tuesday-2	 tuesday-2
newbyth mews	None	 friday-2
newbyth road	 wednesday-1	 friday-2
newcraighall drive	 wednesday-1a	 thursday-1
newcraighall road	 wednesday-1a	 thursday-1
newhalls road	 thursday-1	 wednesday-1
newhaven main street	 wednesday-1	 tuesday-1
newhaven road	 wednesday-1	 friday-1
newington road	 wednesday-1	 wednesday-2
newlands park	 wednesday-1	 thursday-1
newliston road 0 inner lodge j & milrig b & south lodge e	None	 tuesday-1
newmains farm lane	 thursday-1	 thursday-1
newmains road	 thursday-1	 thursday-1
newmills avenue	 wednesday-1	 wednesday-1
newmills crescent	 wednesday-1	 wednesday-1
newmills grove	 wednesday-1	 wednesday-1
newmills road	 wednesday-1	 wednesday-1
newtoft street	 thursday-1	 friday-2
newton street	None	 friday-2
nichollfield	 wednesday-1	 friday-1
niddrie cottages	 wednesday-1a	 thursday-1
niddrie farm grove	 friday-1	 tuesday-2
niddrie house avenue	 friday-1	 tuesday-2
niddrie house drive	 friday-1	 tuesday-2
niddrie house gardens	 friday-1	 tuesday-2
niddrie house park	 friday-1	 tuesday-2
niddrie house square	 friday-1	 tuesday-2
niddrie mains court	 friday-1	 tuesday-2
niddrie mains drive	 friday-1	 tuesday-2
niddrie mains road	 friday-1	 tuesday-2
niddrie marischal crescent	 friday-1	 tuesday-2
niddrie marischal drive	 friday-1	 tuesday-2
niddrie marischal gardens	 friday-1	 tuesday-2
niddrie marischal green	 friday-1	 tuesday-2
niddrie marischal grove	 friday-1	 tuesday-2
niddrie marischal loan	 friday-1	 tuesday-2
niddrie marischal place	 friday-1	 tuesday-2
niddrie marischal road	 friday-1	 tuesday-2
niddrie marischal street	 friday-1	 tuesday-2
niddrie mill avenue	 friday-1	 tuesday-2
niddrie mill crescent	 friday-1	 tuesday-2
niddrie mill drive	 friday-1	 tuesday-2
niddrie mill place	 friday-1	 tuesday-2
niddrie mill terrace	 friday-1	 tuesday-2
nigel loan	 thursday-2	 friday-1
nile grove	 tuesday-2	 wednesday-2
nisbett walk	 wednesday-1	 friday-2
noble place	 wednesday-1	 thursday-2
north bughtlin bank	 thursday-2	 friday-2
north bughtlin brae	 thursday-2	 friday-2
north bughtlin gate	 thursday-2	 friday-2
north bughtlin neuk	 thursday-2	 friday-2
north bughtlinfield	 thursday-2	 friday-2
north bughtlinrig	 thursday-2	 friday-2
north bughtlinside	 thursday-2	 friday-2
north east circus place	 wednesday-1	 tuesday-2
north fort street	 wednesday-1	 friday-1
north greens	 friday-1	 thursday-1
north gyle avenue	 thursday-2	 friday-1
north gyle drive	 thursday-2	 friday-1
north gyle farm court	 thursday-2	 friday-1
north gyle farm lane	 thursday-2	 friday-1
north gyle grove	 thursday-2	 friday-1
north gyle loan	 thursday-2	 friday-1
north gyle park	 thursday-2	 friday-1
north gyle road	 thursday-2	 friday-1
north gyle terrace	 thursday-2	 friday-1
north hillhousefield	 wednesday-1	 friday-1
north meggetland	 wednesday-2	 tuesday-1
north park terrace	 tuesday-2	 thursday-2
north peffer place	 friday-1	 tuesday-2
north platt crescent	 thursday-1	 wednesday-2
north platt gardens	 thursday-1	 wednesday-2
north street	 thursday-1	 wednesday-2
north west circus place	 wednesday-1	 tuesday-2
northfield avenue	None	 wednesday-2
northfield broadway	 friday-2	 wednesday-2
northfield circus	 friday-2	 wednesday-2
northfield crescent	 friday-2	 wednesday-2
northfield drive	 friday-2	 thursday-2
northfield farm avenue	 friday-2	 wednesday-2
northfield farm road	 friday-2	 wednesday-2
northfield gardens	 friday-1	 friday-2
northfield grove	 friday-2	 thursday-2
northfield park	 friday-2	 wednesday-2
northfield park grove	 friday-1	 wednesday-2
northfield road	 friday-2	 wednesday-2
northfield square	 friday-1	 friday-2
northfield terrace	 friday-2	 wednesday-2
northlawn terrace	 friday-1	 thursday-1
northumberland street	 wednesday-1	 tuesday-2
oak lane	 friday-1	 thursday-2
oakfield place	 friday-1	 wednesday-2
oaklands square	 thursday-2	 thursday-2
oakville terrace	 wednesday-1	 thursday-2
oakwood court	 friday-1	 thursday-2
observatory green	 tuesday-2	 tuesday-2
observatory road	 tuesday-2	 tuesday-2
ochil court	 thursday-1	 wednesday-1
ochiltree gardens	 friday-1	 wednesday-2
ogilvie terrace	 tuesday-2	 friday-1
old burdiehouse road	 thursday-1	 thursday-2
old church lane	 wednesday-1	 friday-2
old farm avenue	 wednesday-2	 tuesday-2
old farm place	 wednesday-2	 tuesday-2
old kirk road	 friday-1	 friday-2
old liston road	 thursday-1	 wednesday-2
old mill lane	 thursday-1a	 wednesday-2
old newmills road	 wednesday-1	 wednesday-1
old quarry road	 thursday-1	 wednesday-2
oliver close	 tuesday-1	 thursday-2
orchard bank	 friday-2	 thursday-2
orchard brae	 friday-2	 thursday-2
orchard brae avenue	 friday-2	 thursday-2
orchard brae gardens	 friday-2	 thursday-2
orchard brae gardens west	 friday-2	 thursday-2
orchard brae west	 friday-2	 thursday-2
orchard crescent	 friday-2	 thursday-2
orchard drive	 friday-2	 thursday-2
orchard grove	 friday-2	 thursday-2
orchard place	 friday-2	 thursday-2
orchard road	 friday-2	 thursday-2
orchard road south	 friday-2	 thursday-2
orchard terrace	 friday-2	 thursday-2
orchardfield avenue	 friday-1	 wednesday-2
orchardhead loan	 thursday-2	 wednesday-2
orchardhead road	 thursday-2	 wednesday-2
ormelie terrace	 friday-2	 tuesday-1
ormidale terrace	 friday-2	 tuesday-1
ormiston terrace	None	 friday-2
orrok park	 thursday-2	 friday-1
osborne terrace	 tuesday-2	 tuesday-1
oswald road	 tuesday-2	 tuesday-2
oswald terrace	 friday-1	 thursday-1
otterburn park	 tuesday-2	 wednesday-1
overton farm road	 thursday-1	 tuesday-1
owen view	 tuesday-1	 tuesday-1
oxford street	None	 thursday-1
oxford terrace	 tuesday-1	 thursday-2
oxgangs avenue	 tuesday-1	 wednesday-1
oxgangs bank	 tuesday-1	 wednesday-1
oxgangs brae	 tuesday-1	 thursday-1
oxgangs crescent	 tuesday-1	 wednesday-1
oxgangs farm avenue	 wednesday-2	 friday-1
oxgangs farm drive	 wednesday-2	 friday-1
oxgangs farm gardens	 wednesday-2	 friday-1
oxgangs farm grove	 wednesday-2	 friday-1
oxgangs farm loan	 wednesday-2	 friday-1
oxgangs farm terrace	 wednesday-2	 friday-1
oxgangs gardens	 tuesday-1	 wednesday-1
oxgangs green	 tuesday-1	 wednesday-1
oxgangs hill	 tuesday-1	 wednesday-1
oxgangs loan	 tuesday-1	 wednesday-1
oxgangs medway	 tuesday-1	 thursday-1
oxgangs park	 tuesday-1	 wednesday-1
oxgangs path east	 tuesday-1	 thursday-1
oxgangs place	 tuesday-1	 wednesday-1
oxgangs rise	 tuesday-1	 wednesday-1
oxgangs road	 tuesday-1	 thursday-1
oxgangs row	 tuesday-1	 wednesday-1
oxgangs street	 tuesday-1	 wednesday-1
oxgangs terrace	 tuesday-1	 tuesday-1
oxgangs view	 tuesday-1	 thursday-1
packard street	 thursday-1	 tuesday-2
paisley avenue	 wednesday-2	 thursday-2
paisley drive	 wednesday-2	 thursday-2
paisley gardens	 wednesday-2	 thursday-2
paisley grove	 wednesday-2	 thursday-2
paisley terrace	 wednesday-2	 thursday-2
palmer place	 wednesday-1	 wednesday-1
palmer road	 wednesday-1	 wednesday-1
palmerston place	 tuesday-1	 tuesday-1
palmerston place lane	 tuesday-1	 wednesday-1
palmerston road	 tuesday-2	 wednesday-1
panmure place	None	 tuesday-2
pape's cottages	 friday-1	 wednesday-1
park avenue	 friday-2	 wednesday-1
park crescent	 thursday-2	 thursday-2
park gardens	 thursday-2	 thursday-2
park grove	 thursday-2	 thursday-2
park place	 wednesday-1	 tuesday-1
park road	 wednesday-1	 tuesday-1
park terrace	 wednesday-1a	 thursday-1
park view	 wednesday-1a	 thursday-1
parker avenue	 wednesday-2	 tuesday-2
parker terrace	 wednesday-2	 tuesday-2
parkgrove avenue	 friday-1	 tuesday-2
parkgrove bank	 friday-1	 tuesday-2
parkgrove crescent	 friday-1	 tuesday-2
parkgrove drive	 friday-1	 tuesday-2
parkgrove gardens	 friday-1	 tuesday-2
parkgrove green	 friday-1	 tuesday-2
parkgrove loan	 friday-1	 tuesday-2
parkgrove neuk	 friday-1	 tuesday-2
parkgrove path	 friday-1	 tuesday-1
parkgrove place	 friday-1	 tuesday-2
parkgrove road	 friday-1	 tuesday-2
parkgrove row	 friday-1	 tuesday-2
parkgrove street	 friday-1	 tuesday-2
parkgrove terrace	 friday-1	 tuesday-2
parkgrove view	 friday-1	 tuesday-2
parkhead avenue	 wednesday-2	 wednesday-2
parkhead crescent	 wednesday-2	 wednesday-2
parkhead drive	 wednesday-2	 wednesday-2
parkhead gardens	 wednesday-2	 wednesday-2
parkhead grove	 wednesday-2	 wednesday-2
parkhead loan	 wednesday-2	 wednesday-2
parkhead place	 wednesday-2	 wednesday-2
parkhead street	 wednesday-2	 wednesday-2
parkhead terrace	 wednesday-2	 wednesday-2
parkhead view	 tuesday-1	 thursday-1
parkside	 thursday-1	 wednesday-2
parkside terrace	 friday-1	 wednesday-2
parkvale place	 wednesday-1	 thursday-2
parrotshot	 friday-1	 thursday-1
parsons green terrace	None	 thursday-2
paterson place	 friday-1	 tuesday-2
path brae	 thursday-1	 thursday-1
paties road	 wednesday-2	 wednesday-1
paton place	 wednesday-1a	 thursday-1
pavilion crescent	 thursday-2	 tuesday-1
paxton wynd	 wednesday-1a	 thursday-1
peacocktail close	 wednesday-1a	 thursday-1
pearce avenue	 friday-1	 thursday-2
pearce grove	 friday-1	 thursday-2
pearce road	 friday-1	 thursday-2
peatville gardens	 wednesday-2	 wednesday-2
peatville terrace	 wednesday-2	 wednesday-2
peebles terrace	 tuesday-1	 thursday-2
peel terrace	 wednesday-1	 thursday-1
peffer bank	None	 tuesday-2
peggy's mill road	 friday-1	 tuesday-1
pembroke place	 tuesday-1	 wednesday-1
peniel road	 thursday-1	 tuesday-1
pennywell cottages	 tuesday-1	 tuesday-2
pennywell gardens	 tuesday-1	 thursday-2
pennywell grove	 tuesday-1	 thursday-2
pennywell medway	 tuesday-1	 thursday-2
pennywell place	 tuesday-1	 thursday-2
pennywell road	 tuesday-1	 friday-2
pennywell villas	 tuesday-1	 tuesday-2
pentland crescent	 tuesday-1	 thursday-2
pentland drive	 tuesday-1	 wednesday-1
pentland gardens	 tuesday-1	 thursday-2
pentland grove	 tuesday-1	 thursday-2
pentland place	 wednesday-1	 wednesday-1
pentland road	 wednesday-1	 thursday-2
pentland terrace	 tuesday-1	 thursday-2
pentland view road	 thursday-1	 thursday-1
pentland villas	 wednesday-1	 tuesday-1
perdrixknowe	None	 tuesday-1
perth street	None	 tuesday-2
peveril terrace	 thursday-2	 friday-1
philip terrace	 thursday-2	 wednesday-2
pier place	 wednesday-1	 tuesday-1
piersfield grove	 wednesday-2	 tuesday-1
piersfield place	 wednesday-2	 tuesday-1
piersfield terrace	 wednesday-2	 tuesday-1
piershill terrace	 wednesday-2	 wednesday-2
pikes pool drive	 thursday-1	 thursday-1
pillans square	 wednesday-1	 wednesday-1
pilmuir grove	 wednesday-1	 friday-1
pilrig cottages	 wednesday-1	 friday-1
pilrig gardens	 wednesday-1	 thursday-2
pilrig heights	 wednesday-1	 thursday-2
pilrig street	 wednesday-1	 friday-1
pilton avenue	None	 friday-2
pilton crescent	 tuesday-2	 friday-2
pilton drive	None	 friday-2
pilton drive north	None	 friday-2
pilton gardens	 tuesday-2	 friday-2
pilton loan	 tuesday-1	 friday-2
pilton park	 tuesday-2	 friday-2
pilton place	 tuesday-1	 friday-2
pincott drive	 wednesday-1	 thursday-2
pincott lane	None	 thursday-2
pinegrove gardens	 thursday-2	 tuesday-1
pinkhill	 friday-1	 friday-2
pinkhill park	None	 thursday-1
pirniefield bank	 wednesday-1	 thursday-2
pirniefield gardens	 wednesday-1	 thursday-2
pirniefield grove	 wednesday-1	 thursday-2
pirniefield place	 wednesday-1	 wednesday-1
pirniefield terrace	 wednesday-1	 wednesday-1
pitcairn grove	 tuesday-1	 tuesday-1
pitlochry place	None	 thursday-1
pitsligo road	 tuesday-2	 tuesday-2
pitt street	None	 friday-1
pittville street	 friday-2	 tuesday-1
pleasance	None	 wednesday-2
plewlandcroft	 thursday-1	 wednesday-1
plewlands avenue	 tuesday-1	 thursday-1
plewlands gardens	 tuesday-1	 thursday-1
plewlands place	 thursday-1	 wednesday-1
plewlands terrace	 tuesday-1	 thursday-1
pleydell place	 thursday-2	 friday-1
pollard glebe	 thursday-2	 tuesday-2
polwarth crescent	None	 friday-1
polwarth gardens	 tuesday-2	 friday-1
polwarth grove	 tuesday-2	 friday-1
polwarth park	 tuesday-2	 friday-1
polwarth place	 tuesday-2	 friday-1
polwarth terrace	 tuesday-2	 friday-1
poplar lane	 wednesday-1	 wednesday-1
portland street	 wednesday-1	 friday-1
portmore drive	 thursday-2	 thursday-2
portobello high street	 friday-2	 friday-2
powderhall road	 wednesday-1	 friday-1
prestonfield avenue	 friday-1	 thursday-1
prestonfield bank	 friday-1	 thursday-1
prestonfield crescent	 friday-1	 thursday-1
prestonfield gardens	 friday-1	 thursday-1
prestonfield road	 friday-1	 thursday-1
prestonfield terrace	 friday-1	 thursday-1
priestfield avenue	 friday-1	 thursday-1
priestfield crescent	 friday-1	 thursday-1
priestfield gardens	 friday-1	 thursday-1
priestfield grove	 friday-1	 thursday-1
priestfield road	 friday-1	 thursday-1
priestfield road north	 friday-1	 thursday-1
priesthill place	 thursday-2	 wednesday-2
priesthill street	 thursday-2	 wednesday-2
primrose bank road	 tuesday-2	 wednesday-1
primrose gardens	 thursday-1	 wednesday-1
primrose terrace	 tuesday-1	 wednesday-1
prince regent street	None	 friday-1
princess mary road	 friday-1	 tuesday-2
pringle drive	 friday-1	 tuesday-2
printonan crescent	 thursday-2	 wednesday-2
priory grove	 thursday-1	 wednesday-1
promenade	 friday-1	 friday-2
prospect bank crescent	 wednesday-1	 wednesday-1
prospect bank gardens	 wednesday-1	 wednesday-1
prospect bank grove	 wednesday-1	 wednesday-1
prospect bank place	 wednesday-1	 wednesday-1
prospect bank road	 wednesday-1	 wednesday-1
prospect bank terrace	 wednesday-1	 wednesday-1
provost milne grove	 thursday-1	 tuesday-2
quality street	 friday-1	 thursday-1
quality street lane	 friday-1	 thursday-1
quarry cottages	 wednesday-1a	 thursday-1
quarrybank	 wednesday-1	 wednesday-2
quarrybank close	 wednesday-1	 wednesday-2
quarrybank court	 wednesday-1	 wednesday-2
quarrybank end	 wednesday-1	 wednesday-2
quarrypark drive	 thursday-1	 wednesday-2
quarryview	 wednesday-1	 wednesday-2
queen charlotte street	 wednesday-1	 wednesday-1
queen margaret close	 tuesday-1	 tuesday-1
queen margaret drive	 thursday-1	 wednesday-1
queen's avenue	 friday-2	 wednesday-2
queen's avenue south	 friday-2	 wednesday-2
queen's bay crescent	 friday-2	 wednesday-1
queen's crescent	 wednesday-1	 thursday-1
queen's gardens	 friday-2	 wednesday-2
queen's park avenue	 wednesday-2	 thursday-1
queen's road	 friday-2	 wednesday-2
queensferry terrace	 friday-2	 thursday-2
quintinshill place	 wednesday-1	 friday-1
raeburn place	None	 thursday-2
ramslack street	 wednesday-1	 wednesday-1
randolph crescent	 wednesday-1	 wednesday-1
rankeillor street	None	 wednesday-2
rankin avenue	 tuesday-2	 tuesday-2
rankin drive	 tuesday-2	 tuesday-2
rankin road	 tuesday-2	 tuesday-1
rannoch grove	 friday-1	 thursday-2
rannoch place	 friday-1	 thursday-2
rannoch road	 friday-1	 thursday-2
rannoch terrace	 friday-1	 thursday-2
ransome gardens	 friday-1	 thursday-2
ratho mains	 thursday-1	 tuesday-1
ratho park road	 thursday-1	 wednesday-2
rattray drive	 tuesday-1	 tuesday-1
rattray grove	 tuesday-1	 tuesday-1
rattray loan	 tuesday-1	 tuesday-1
rattray way	 tuesday-1	 tuesday-1
ravelrig drive	 wednesday-1	 friday-1
ravelrig gait	 wednesday-1	 friday-1
ravelrig hill	 wednesday-1	 friday-1
ravelrig park	 wednesday-1	 friday-1
ravelrig road	 wednesday-1	 friday-1
ravelrig wynd	 wednesday-1	 friday-1
ravelston dykes	 friday-2	 tuesday-1
ravelston dykes lane	 friday-2	 thursday-1
ravelston house grove	 friday-2	 wednesday-2
ravelston house loan	 friday-2	 wednesday-2
ravelston house park	 friday-2	 wednesday-2
ravelston house road	 friday-2	 wednesday-2
ravelston park	 friday-2	 tuesday-1
ravelston place	 friday-2	 tuesday-1
ravelston rise	 friday-2	 tuesday-1
ravelston terrace	 friday-2	 tuesday-1
ravenscroft gardens	 thursday-1	 friday-2
ravenscroft place	 thursday-1	 friday-2
ravenscroft street	 thursday-1	 friday-2
redbraes grove	 wednesday-1	 friday-1
redbraes place	 wednesday-1	 friday-1
redford avenue	 wednesday-2	 tuesday-2
redford bank	 wednesday-2	 friday-1
redford crescent	 wednesday-2	 tuesday-2
redford drive	 wednesday-2	 tuesday-2
redford gardens	 wednesday-2	 friday-1
redford grove	 wednesday-2	 friday-1
redford loan	 wednesday-2	 tuesday-2
redford neuk	 wednesday-2	 friday-1
redford place	 wednesday-2	 friday-1
redford terrace	 wednesday-2	 tuesday-2
redford walk	 wednesday-2	 friday-1
redgauntlet terrace	 friday-1	 friday-1
redhall avenue	 wednesday-2	 wednesday-2
redhall bank road	 tuesday-2	 thursday-2
redhall crescent	 wednesday-2	 thursday-1
redhall drive	 wednesday-2	 wednesday-2
redhall gardens	 wednesday-2	 wednesday-2
redhall grove	 wednesday-2	 wednesday-2
redhall house avenue	 tuesday-2	 wednesday-1
redhall house close	 tuesday-2	 wednesday-1
redhall house drive	 tuesday-2	 wednesday-1
redhall place	 wednesday-2	 wednesday-2
redhall road	 wednesday-2	 wednesday-2
redhall view	 tuesday-2	 thursday-2
regent place	None	 thursday-1
regent street	 friday-1	 friday-2
regent terrace	 wednesday-1	 thursday-1
regis court	 friday-1	 wednesday-1
reid terrace	 tuesday-1	 tuesday-2
relugas gardens	 tuesday-2	 tuesday-2
relugas place	 tuesday-2	 tuesday-2
relugas road	 tuesday-2	 tuesday-2
restalrig avenue	 wednesday-2	 tuesday-1
restalrig circus	 wednesday-1	 wednesday-1
restalrig crescent	 wednesday-1	 wednesday-1
restalrig drive	 wednesday-2	 tuesday-1
restalrig gardens	 wednesday-2	 thursday-1
restalrig road	 wednesday-1	 wednesday-1
restalrig square	 wednesday-1	 thursday-2
restalrig terrace	 wednesday-1	 thursday-2
reynolds road	 tuesday-1	 thursday-2
riccarton avenue	 wednesday-1	 friday-2
riccarton crescent	 wednesday-1	 friday-2
riccarton drive	 wednesday-1	 friday-2
riccarton grove	 wednesday-1	 friday-2
riccarton mains road	 wednesday-1	 friday-2
richmond terrace	 tuesday-1	 wednesday-1
riding park	 friday-1	 wednesday-1
rintoul place	 tuesday-1	 tuesday-2
riselaw crescent	 tuesday-1	 thursday-2
riselaw place	 tuesday-1	 thursday-2
riselaw road	 tuesday-1	 thursday-2
riselaw terrace	 tuesday-1	 thursday-2
riversdale crescent	 friday-2	 wednesday-1
riversdale grove	 friday-2	 wednesday-1
riversdale road	 friday-2	 wednesday-1
riverside	None	 wednesday-2
robb's loan	 tuesday-2	 friday-2
robert burns drive	 thursday-2	 friday-1
rocheid park	 tuesday-2	 friday-1
rochester terrace	 tuesday-2	 tuesday-2
roddinglaw road	 thursday-1	 tuesday-1
rodney street	 wednesday-1	 tuesday-2
rona avenue	 thursday-2	 wednesday-2
rose lane	 thursday-1	 wednesday-1
rosebank cottages	 tuesday-1	 wednesday-1
rosebank gardens	 tuesday-1	 wednesday-1
rosebank grove	 tuesday-2	 wednesday-1
rosebank road	 tuesday-2	 wednesday-1
rosebery avenue	 thursday-1	 wednesday-1
rosebery court	 thursday-1	 wednesday-1
rosebery crescent	 tuesday-1	 tuesday-1
rosebery crescent lane	 tuesday-1	 wednesday-1
roseburn avenue	 tuesday-2	 tuesday-1
roseburn cliff	 friday-1	 tuesday-1
roseburn crescent	 tuesday-2	 tuesday-1
roseburn drive	 tuesday-2	 tuesday-1
roseburn place	 tuesday-2	 tuesday-1
roseburn street	 tuesday-2	 tuesday-1
roseburn terrace	None	 wednesday-1
rosefield avenue	 friday-1	 friday-2
rosefield avenue lane	 friday-1	 friday-2
rosefield place	 friday-1	 friday-2
rosefield street	 friday-1	 friday-2
roseneath street	None	 wednesday-1
roseneath terrace	None	 wednesday-1
roseville gardens	 tuesday-2	 tuesday-1
ross gardens	 tuesday-2	 tuesday-1
ross place	 tuesday-2	 tuesday-1
ross road	 thursday-2	 wednesday-2
rosshill terrace	 thursday-1	 wednesday-1
rosslyn crescent	 wednesday-1	 friday-1
rosslyn terrace	 wednesday-1	 friday-1
rothesay terrace	 tuesday-1	 tuesday-1
roull grove	 friday-1	 tuesday-2
roull place	 friday-1	 tuesday-2
roull road	 friday-1	 tuesday-2
rowallan court	 thursday-2	 friday-2
rowantree avenue	 wednesday-1	 wednesday-1
rowantree grove	 wednesday-1	 wednesday-1
rowieston drive	 thursday-2	 wednesday-2
roxburgh street	None	 wednesday-2
royal circus	 wednesday-1	 tuesday-2
royal crescent	 wednesday-1	 tuesday-2
royal park terrace	None	 thursday-1
royal terrace	 wednesday-1	 thursday-1
royston mains avenue	 tuesday-1	 friday-2
royston mains crescent	 tuesday-1	 friday-2
royston mains gardens	 tuesday-1	 friday-2
royston mains green	 tuesday-1	 friday-2
royston mains place	 tuesday-1	 friday-2
royston mains road	 tuesday-1	 friday-2
royston mains street	 tuesday-1	 friday-2
royston terrace	None	 friday-1
russell place	 tuesday-2	 tuesday-1
rustic cottages	 wednesday-2	 tuesday-2
rutherford drive	 thursday-2	 friday-1
ruthven place	 friday-1	 friday-1
ryehill avenue	 wednesday-1	 thursday-2
ryehill gardens	 wednesday-1	 thursday-2
ryehill grove	 wednesday-1	 thursday-2
ryehill place	 wednesday-1	 thursday-2
ryehill terrace	 wednesday-1	 thursday-2
saddle tree loan	 friday-1	 friday-1
salisbury road	 wednesday-1	 thursday-1
salmond place	None	 thursday-1
salvesen crescent	 tuesday-1	 tuesday-2
salvesen gardens	 tuesday-1	 tuesday-2
salvesen grove	 tuesday-1	 tuesday-2
salvesen terrace	 tuesday-1	 tuesday-2
sandercombe drive	 thursday-1	 tuesday-2
sandford gardens	 friday-2	 wednesday-1
sandstone crescent	 friday-1	 thursday-1
sassoon grove	 tuesday-1	 thursday-1
saughton avenue	 tuesday-1	 friday-2
saughton crescent	 friday-2	 wednesday-1
saughton gardens	 friday-2	 wednesday-1
saughton grove	 friday-2	 wednesday-1
saughton loan	 friday-2	 wednesday-1
saughton mains bank	 thursday-2	 tuesday-2
saughton mains drive	 thursday-2	 wednesday-2
saughton mains gardens	 thursday-2	 tuesday-2
saughton mains grove	 thursday-2	 wednesday-2
saughton mains loan	 thursday-2	 wednesday-2
saughton mains terrace	 thursday-2	 tuesday-2
saughton park	 friday-2	 wednesday-1
saughton road north	 friday-1	 thursday-1
saughtonhall avenue	 friday-2	 wednesday-1
saughtonhall avenue west	 friday-2	 wednesday-1
saughtonhall circus	 friday-2	 wednesday-1
saughtonhall crescent	 friday-2	 wednesday-1
saughtonhall drive	 friday-2	 wednesday-1
saughtonhall gardens	 friday-2	 wednesday-1
saughtonhall grove	 friday-2	 wednesday-1
saughtonhall place	 friday-2	 wednesday-1
saughtonhall terrace	 friday-2	 wednesday-1
savile place	 tuesday-2	 tuesday-1
savile terrace	 tuesday-1	 wednesday-2
saxe-coburg place	 wednesday-1	 tuesday-2
saxe-coburg street	 wednesday-1	 tuesday-2
saxe-coburg terrace	 wednesday-1	 tuesday-2
scald law drive	 wednesday-2	 tuesday-2
scanlan street	 wednesday-1a	 thursday-1
school brae	 friday-1	 wednesday-1
sciennes gardens	 tuesday-2	 wednesday-1
sciennes hill place	 tuesday-1	 wednesday-1
sciennes road	 tuesday-2	 wednesday-1
scone gardens	 wednesday-1	 thursday-2
scotland street	 wednesday-1	 tuesday-2
scotstoun avenue	 thursday-1	 tuesday-2
scotstoun green	 thursday-1	 tuesday-2
scotstoun park	 thursday-1	 tuesday-2
scott street	 friday-1	 tuesday-2
seacot	 wednesday-1	 thursday-2
seafield avenue	 wednesday-1	 thursday-2
seafield road	 wednesday-1	 wednesday-1
seaforth drive	 friday-2	 wednesday-2
seaview crescent	 friday-2	 tuesday-1
seaview terrace	 friday-2	 tuesday-1
seton place	 tuesday-2	 wednesday-1
shale road	 thursday-1	 thursday-2
shandon crescent	 tuesday-1	 wednesday-1
shandon place	 tuesday-2	 friday-1
shandon road	 tuesday-2	 wednesday-1
shandon street	 tuesday-2	 wednesday-1
shandon terrace	 tuesday-1	 wednesday-1
shandwick place	None	 wednesday-1
shanter way	 thursday-1	 friday-1
shavelin drive	 wednesday-1a	 thursday-1
shaw's place	None	 thursday-1
shaw's street	None	 thursday-1
shaw's terrace	None	 thursday-1
shearie knowe gardens	 wednesday-2	 tuesday-2
shiels way	 wednesday-1	 wednesday-1
shore road	 thursday-1	 wednesday-1
shrub mount	None	 friday-2
sidings way	 tuesday-2	 friday-2
sighthill crescent	 wednesday-2	 thursday-2
sighthill drive	 wednesday-2	 thursday-2
sighthill gardens	 wednesday-2	 thursday-2
sighthill grove	 wednesday-2	 thursday-2
sighthill loan	 wednesday-2	 thursday-2
sighthill neuk	 wednesday-2	 thursday-2
sighthill park	 wednesday-2	 thursday-2
sighthill place	 wednesday-2	 thursday-2
sighthill rise	 wednesday-2	 thursday-1
sighthill road	 wednesday-2	 thursday-2
sighthill street	 wednesday-2	 thursday-2
sighthill terrace	 wednesday-2	 thursday-2
silverknowes avenue	 tuesday-1	 thursday-1
silverknowes bank	 tuesday-1	 thursday-2
silverknowes brae	 tuesday-1	 thursday-2
silverknowes court	 tuesday-1	 thursday-2
silverknowes crescent	 tuesday-1	 thursday-1
silverknowes dell	 friday-1	 thursday-1
silverknowes drive	 tuesday-1	 thursday-1
silverknowes eastway	 tuesday-1	 thursday-2
silverknowes gardens	 tuesday-1	 thursday-2
silverknowes green	 tuesday-1	 thursday-2
silverknowes grove	 tuesday-1	 thursday-2
silverknowes hill	 tuesday-1	 thursday-1
silverknowes loan	 tuesday-1	 thursday-1
silverknowes midway	 tuesday-1	 thursday-2
silverknowes neuk	 friday-2	 thursday-1
silverknowes parkway	 tuesday-1	 thursday-2
silverknowes place	 tuesday-1	 thursday-2
silverknowes road east	 tuesday-1	 thursday-2
silverknowes road south	 friday-1	 thursday-1
silverknowes southway	 tuesday-1	 thursday-2
silverknowes terrace	 tuesday-1	 thursday-1
silverknowes view	 tuesday-1	 thursday-2
sinclair place	 tuesday-1	 wednesday-1
skerryvore loan	 tuesday-1	 friday-2
slaeside	 wednesday-1	 thursday-1
slateford gait	 tuesday-1	 wednesday-1
sleigh drive	 wednesday-2	 wednesday-1
sleigh gardens	 wednesday-2	 wednesday-1
sloan street	None	 thursday-1
smeaton gardens	 friday-1	 tuesday-2
smith's land	 thursday-1	 wednesday-1
society road	 thursday-1	 tuesday-1
somerset place	 wednesday-1	 thursday-2
somerville road	 wednesday-1	 wednesday-1
sommerville gardens	 thursday-1	 tuesday-2
south barnton avenue	 friday-1	 thursday-1
south beechwood	 friday-2	 wednesday-1
south elixa place	 friday-2	 wednesday-2
south ettrick road	 tuesday-2	 friday-1
south fort street	 wednesday-1	 friday-1
south gayfield lane	 wednesday-1	 tuesday-2
south gillsland road	 tuesday-2	 friday-1
south gray street	 tuesday-2	 tuesday-1
south gyle gardens	None	 tuesday-2
south gyle loan	 thursday-2	 friday-1
south gyle mains	 thursday-2	 friday-1
south gyle park	 thursday-2	 friday-1
south gyle wynd	 thursday-2	 friday-1
south lauder road	 tuesday-2	 wednesday-1
south laverockbank avenue	 tuesday-2	 tuesday-1
south learmonth avenue	 tuesday-1	 thursday-2
south learmonth gardens	 tuesday-1	 thursday-2
south lorne place	 wednesday-1	 thursday-1
south mellis park	 friday-2	 tuesday-1
south morton street	 friday-2	 wednesday-1
south oswald road	 tuesday-2	 tuesday-2
south oxford street	None	 thursday-1
south park	 wednesday-1	 tuesday-1
south parrotshot	 friday-1	 thursday-1
south scotstoun	 thursday-1	 tuesday-2
south sloan street	None	 thursday-1
south steil	 tuesday-1	 tuesday-1
south trinity road	 tuesday-2	 wednesday-1
southfield bank	 friday-2	 friday-2
southfield farm grove	 friday-2	 thursday-2
southfield gardens east	 friday-2	 friday-2
southfield gardens west	 friday-2	 friday-2
southfield loan	 friday-2	 friday-2
southfield road east	 friday-2	 friday-2
southfield road west	 friday-2	 friday-2
southfield square	 friday-2	 friday-2
southfield terrace	 friday-2	 friday-2
southfield villas	 friday-2	 wednesday-1
southhouse avenue	 thursday-1	 thursday-2
southhouse brae	 thursday-1	 thursday-2
southhouse broadway	 thursday-1	 thursday-2
southhouse close	 thursday-1	 thursday-2
southhouse crescent	 thursday-1	 thursday-2
southhouse crossway	 thursday-1	 thursday-2
southhouse drive	 thursday-1	 thursday-2
southhouse gardens	 thursday-1	 thursday-2
southhouse grove	 thursday-1	 thursday-2
southhouse loan	 thursday-1	 thursday-2
southhouse place	 thursday-1	 thursday-2
southhouse road	 thursday-1	 thursday-2
southhouse terrace	 thursday-1	 thursday-2
southhouse walk	 thursday-1	 thursday-2
soutra road	 thursday-2	 wednesday-2
spa place	 friday-1	 friday-2
spence street	 wednesday-1	 thursday-1
spencer place	 tuesday-2	 tuesday-1
spey terrace	None	 thursday-1
spinner lane	 thursday-2	 wednesday-2
spottiswoode road	None	 wednesday-1
spottiswoode street	None	 wednesday-1
spring gardens	 wednesday-2	 thursday-1
springfield	 wednesday-1	 friday-1
springfield crescent	 thursday-1	 tuesday-1
springfield lea	 thursday-1	 tuesday-1
springfield place	 thursday-1	 tuesday-1
springfield road	 thursday-1	 tuesday-1
springfield street	 wednesday-1	 friday-1
springfield terrace	 thursday-1	 tuesday-1
springfield view	 thursday-1	 tuesday-1
springvalley gardens	None	 wednesday-2
springvalley terrace	None	 wednesday-2
springwell place	None	 tuesday-1
springwell terrace	 thursday-1	 wednesday-1
springwood park	 thursday-2	 thursday-2
spruce way	 tuesday-1	 wednesday-1
spylaw avenue	 wednesday-1	 thursday-2
spylaw park	 wednesday-1	 thursday-2
spylaw road	 tuesday-2	 friday-1
spylaw street	 wednesday-1	 thursday-1
st bernard's crescent	 tuesday-1	 thursday-2
st bernard's row	 tuesday-1	 tuesday-2
st catherine's gardens	 friday-1	 friday-2
st catherine's place	 tuesday-2	 wednesday-1
st clair avenue	 wednesday-1	 thursday-1
st clair place	 wednesday-1	 thursday-1
st clair road	 wednesday-1	 thursday-1
st clair street	 wednesday-1	 thursday-1
st clair terrace	 tuesday-1	 thursday-1
st fillan's terrace	 tuesday-1	 thursday-1
st francis way	 friday-1	 tuesday-2
st john's avenue	 friday-1	 thursday-1
st john's crescent	 friday-1	 friday-2
st john's gardens	 friday-1	 thursday-1
st john's terrace	 friday-1	 thursday-1
st katharine's brae	 thursday-2	 wednesday-2
st katharine's crescent	 thursday-2	 wednesday-2
st katharine's loan	 thursday-2	 wednesday-2
st leonard's bank	 friday-1	 wednesday-2
st leonard's hill	 friday-1	 thursday-1
st margaret's place	None	 wednesday-1
st margaret's road	 tuesday-2	 tuesday-2
st mark's lane	 friday-1	 friday-2
st mark's place	 friday-2	 tuesday-1
st martins glebe	None	 thursday-1
st mary's place	 friday-2	 tuesday-1
st ninian's drive	 friday-1	 friday-2
st ninian's road	 friday-1	 friday-2
st ninian's terrace	 tuesday-1	 thursday-1
st peter's place	 tuesday-2	 tuesday-2
st ronan's terrace	 tuesday-1	 thursday-1
st stephen place	None	 tuesday-2
st stephen street	None	 tuesday-2
st teresa place	 tuesday-1	 friday-1
st thomas road	 tuesday-2	 wednesday-1
stair park	 friday-2	 tuesday-1
stair place	 thursday-1	 tuesday-2
standingstane road	 thursday-1	 tuesday-1
stanedykehead	 thursday-1	 wednesday-2
stanhope place	 tuesday-2	 wednesday-1
stanhope street	 tuesday-2	 wednesday-1
stanley place	 wednesday-2	 thursday-1
stanley road	 wednesday-1	 tuesday-1
stanley street	 friday-2	 wednesday-1
stanwell street	 wednesday-1	 friday-1
stapeley avenue	 wednesday-2	 tuesday-2
starbank road	 tuesday-2	 tuesday-1
stark's cottages	 tuesday-1	 tuesday-1
station loan	 wednesday-1	 friday-1
station terrace	 thursday-1	 tuesday-1
station view	 thursday-1	 wednesday-1
stein street	 thursday-1	 wednesday-1
stenhouse avenue	 wednesday-2	 tuesday-2
stenhouse avenue west	 wednesday-2	 tuesday-2
stenhouse cottages	 wednesday-2	 tuesday-2
stenhouse crescent	 wednesday-2	 tuesday-2
stenhouse drive	 wednesday-2	 tuesday-2
stenhouse gardens	 wednesday-2	 tuesday-2
stenhouse gardens north	 wednesday-2	 tuesday-2
stenhouse grove	 wednesday-2	 tuesday-2
stenhouse mill crescent	 wednesday-2	 wednesday-1
stenhouse mill lane	 wednesday-1	 wednesday-1
stenhouse place east	 wednesday-2	 tuesday-2
stenhouse place west	 wednesday-2	 tuesday-2
stenhouse road	None	 tuesday-2
stenhouse street east	 wednesday-2	 tuesday-2
stenhouse street west	 wednesday-2	 tuesday-2
stenhouse terrace	 wednesday-2	 tuesday-2
stennis gardens	 thursday-2	 friday-2
stevenson avenue	 tuesday-2	 friday-2
stevenson drive	 wednesday-2	 tuesday-2
stevenson grove	 tuesday-2	 friday-2
stevenson road	 tuesday-2	 friday-2
stevenson terrace	 tuesday-2	 friday-2
stewart avenue	 wednesday-1	 wednesday-1
stewart clark avenue	 thursday-1	 wednesday-1
stewart crescent	 wednesday-1	 wednesday-1
stewart gardens	 wednesday-1	 wednesday-1
stewart road	 wednesday-1	 wednesday-1
stillhouse loan	 thursday-1	 thursday-1
stoneycroft road	 thursday-1	 tuesday-1
stoneyflatts	 thursday-1	 tuesday-1
stoneyflatts crescent	 thursday-1	 tuesday-1
stoneyflatts park	 thursday-1	 tuesday-1
strachan gardens	 friday-2	 friday-1
strachan road	 friday-2	 friday-1
straiton place	 friday-2	 friday-2
strathalmond court	 thursday-2	 tuesday-1
strathalmond green	 thursday-2	 tuesday-1
strathalmond park	 thursday-2	 tuesday-1
strathalmond road	 thursday-2	 tuesday-1
strathearn place	 tuesday-2	 tuesday-2
strathearn road	None	 tuesday-2
strathfillan road	None	 tuesday-2
stuart crescent	 thursday-2	 thursday-2
stuart green	 thursday-2	 thursday-2
stuart park	 thursday-2	 thursday-2
stuart wynd	 thursday-2	 thursday-2
succoth avenue	 friday-2	 tuesday-1
succoth gardens	 friday-2	 tuesday-1
succoth park	 friday-2	 tuesday-1
succoth place	 friday-2	 tuesday-1
suffolk road	None	 tuesday-1
suffolk road lane	 thursday-1	 tuesday-1
summerfield gardens	 wednesday-1	 thursday-2
summerfield place	 wednesday-1	 thursday-2
summerside place	 wednesday-1	 friday-1
summerside street	 wednesday-1	 friday-1
summertrees court	 friday-1	 friday-1
sunbury place	 tuesday-1	 wednesday-1
sutherland street	 tuesday-2	 wednesday-1
swan spring avenue	 tuesday-1	 thursday-2
swanston avenue	 tuesday-1	 tuesday-1
swanston crescent	 tuesday-1	 thursday-1
swanston drive	 tuesday-1	 tuesday-1
swanston gardens	 tuesday-1	 tuesday-1
swanston green	 tuesday-1	 thursday-1
swanston grove	 tuesday-1	 tuesday-1
swanston loan	 tuesday-1	 thursday-1
swanston muir	 wednesday-2	 friday-1
swanston park	 tuesday-1	 thursday-1
swanston place	 tuesday-1	 tuesday-1
swanston road	 wednesday-1	 thursday-1
swanston row	 tuesday-1	 thursday-1
swanston terrace	 tuesday-1	 tuesday-1
swanston view	 tuesday-1	 tuesday-1
swanston village	 wednesday-1	 thursday-1
swanston way	 tuesday-1	 thursday-1
sycamore gardens	 friday-1	 thursday-1
sycamore terrace	 friday-1	 thursday-1
sydney park	 wednesday-2	 tuesday-2
sydney place	 wednesday-2	 tuesday-2
sydney terrace	 wednesday-2	 tuesday-2
sylvan place	 tuesday-2	 wednesday-1
syme place	 tuesday-1	 tuesday-1
syme rigg	 tuesday-1	 tuesday-1
talisman place	 thursday-2	 friday-1
talla street	 thursday-2	 thursday-2
tansy street	 wednesday-1	 tuesday-1
tantallon place	 tuesday-2	 wednesday-1
tarvit street	None	 wednesday-1
tay street	None	 friday-1
telford drive	 friday-2	 tuesday-2
telford gardens	 friday-2	 tuesday-2
telford place	 friday-2	 tuesday-2
templar crescent	 thursday-1	 tuesday-2
templar's cramond	 friday-1	 wednesday-1
temple park crescent	 tuesday-2	 friday-1
templeland grove	 friday-1	 wednesday-2
templeland road	 friday-1	 wednesday-2
tennant street	 wednesday-1	 friday-1
teviotdale place	 tuesday-1	 tuesday-2
the bowling green	 wednesday-1	 friday-1
the causeway	 wednesday-1	 friday-2
the cedars	 wednesday-1	 tuesday-2
the crescent	 tuesday-1	 thursday-1
the gallolee	 wednesday-2	 friday-1
the loan	 thursday-1	 tuesday-1
the murrays	 thursday-1	 thursday-2
the murrays brae	 thursday-1	 thursday-2
the north walk	 tuesday-1	 thursday-1
the paddockholm	 friday-1	 thursday-1
the pottery	 friday-1	 friday-2
the quilts	 wednesday-1	 friday-1
the spinney	 thursday-1	 friday-1
the square	 thursday-1	 thursday-1
the steils	 tuesday-1	 tuesday-1
the wisp	 friday-1	 tuesday-2
thirlestane lane	 tuesday-1	 wednesday-2
thirlestane road	None	 wednesday-1
thistle place	None	 wednesday-1
thomson crescent	 wednesday-1	 tuesday-1
thomson drive	 wednesday-1	 tuesday-1
thomson grove	 wednesday-1	 tuesday-1
thomson place	 thursday-1	 wednesday-1
thomson road	 wednesday-1	 tuesday-1
thorburn grove	 wednesday-2	 tuesday-2
thorburn road	 wednesday-2	 tuesday-2
thorntree street	 wednesday-1	 thursday-1
thornville terrace	 wednesday-1	 thursday-2
thorters place	 thursday-2	 thursday-2
threipmuir avenue	 wednesday-1	 thursday-1
threipmuir gardens	 wednesday-1	 thursday-1
threipmuir place	 wednesday-1	 thursday-1
timmins court	 thursday-1	 wednesday-2
tipperlinn road	 tuesday-2	 friday-1
tobias street	 friday-1	 tuesday-2
toddshill road	 thursday-1	 thursday-1
todshaugh gardens	 thursday-1	 thursday-1
tor lane	 thursday-2	 wednesday-2
torduff road	 wednesday-1a	 thursday-1
tormain bank	 thursday-1	 wednesday-2
tormain drive	 thursday-1	 wednesday-2
torrance park	 friday-1	 thursday-2
torrance place	None	 friday-2
torrance row	 wednesday-1	 friday-2
torrance way	 wednesday-1	 friday-2
torwood crescent	 thursday-2	 friday-1
toward court	 thursday-2	 friday-2
traquair park east	 friday-1	 thursday-1
traquair park west	 friday-1	 thursday-1
trench knowe	 tuesday-1	 thursday-1
tressilian gardens	 thursday-2	 friday-1
trinity court	None	 wednesday-1
trinity grove	 tuesday-2	 tuesday-1
trinity mains	 tuesday-2	 tuesday-1
trotter haugh	 tuesday-2	 tuesday-2
tryst park	 wednesday-2	 thursday-1
tudsbery avenue	 friday-1	 tuesday-2
turner avenue	 wednesday-1	 friday-1
turner park	 wednesday-1	 friday-1
tweedie lane	 wednesday-1	 friday-2
tweedsmuir drive	 thursday-1	 tuesday-2
tweedsmuir gait	 thursday-1	 tuesday-2
tyler's acre avenue	 friday-1	 thursday-1
tyler's acre gardens	 friday-1	 thursday-1
tyler's acre road	 friday-1	 thursday-1
ulster crescent	 wednesday-2	 thursday-2
ulster drive	 wednesday-2	 wednesday-2
ulster gardens	 wednesday-2	 thursday-2
ulster grove	 wednesday-2	 thursday-2
ulster terrace	 wednesday-2	 thursday-2
umbrella pine terrace	None	 friday-2
upper coltbridge terrace	 friday-1	 wednesday-1
upper craigour	 thursday-1	 tuesday-2
upper craigour way	 thursday-1	 tuesday-2
upper cramond court	 friday-1	 wednesday-1
upper dean terrace	 wednesday-1	 tuesday-2
upper gilmore place	 tuesday-2	 wednesday-1
upper gilmore terrace	 tuesday-1	 wednesday-1
upper gray street	 tuesday-2	 tuesday-1
upper grove place	None	 wednesday-1
usher mews	None	 tuesday-2
valleyfield street	None	 wednesday-1
vanburgh place	 wednesday-1	 wednesday-1
vandeleur avenue	 wednesday-2	 tuesday-2
vandeleur grove	 wednesday-2	 tuesday-2
vandeleur place	 wednesday-2	 tuesday-2
ventnor place	 wednesday-1	 thursday-1
ventnor terrace	 wednesday-1	 thursday-1
venturefair drive	 thursday-1	 friday-2
vexhim park	 friday-1	 thursday-1
victor park terrace	 friday-1	 friday-2
viewfield road	 tuesday-2	 thursday-2
viewforth	 tuesday-2	 tuesday-2
viewforth place	 thursday-1	 wednesday-1
viewforth road	 thursday-1	 wednesday-1
viewforth square	None	 wednesday-1
viewforth terrace	 tuesday-2	 tuesday-2
villa road	 thursday-1	 tuesday-1
violet terrace	 tuesday-1	 friday-1
vivian terrace	 friday-1	 thursday-1
wakefield avenue	 wednesday-2	 tuesday-2
walford drive	 friday-2	 tuesday-2
walker drive	 thursday-1	 tuesday-1
walker terrace	 tuesday-1	 wednesday-1
walkers court	 wednesday-2	 thursday-2
walkers rigg	 wednesday-2	 thursday-2
walkers wynd	 wednesday-2	 thursday-2
wallace gardens	 friday-2	 wednesday-1
wardie avenue	 tuesday-2	 thursday-1
wardie crescent	 tuesday-2	 thursday-1
wardie dell	 tuesday-2	 thursday-1
wardie grove	 tuesday-2	 thursday-1
wardie house lane	 tuesday-2	 wednesday-1
wardie park	 tuesday-2	 thursday-1
wardie road	 tuesday-2	 wednesday-1
wardie steps	None	 wednesday-1
wardieburn drive	 tuesday-2	 thursday-1
wardieburn place east	 tuesday-2	 friday-2
wardieburn place west	 tuesday-2	 friday-2
wardieburn road	 tuesday-2	 friday-2
wardieburn street east	 tuesday-2	 friday-2
wardieburn terrace	 tuesday-2	 friday-2
wardlaw place	None	 friday-2
wardlaw terrace	None	 friday-2
warrender park crescent	None	 wednesday-1
warrender park road	None	 wednesday-1
warrender park terrace	None	 wednesday-1
warriston avenue	 tuesday-2	 friday-1
warriston crescent	 tuesday-1	 tuesday-2
warriston drive	 tuesday-2	 friday-1
warriston gardens	 tuesday-2	 friday-1
warriston grove	 tuesday-2	 friday-1
warriston road	 tuesday-1	 tuesday-2
warriston terrace	 tuesday-1	 tuesday-2
waterfield road	 tuesday-1	 friday-2
watertoun road	 tuesday-2	 tuesday-2
watson crescent	None	 friday-1
watt park	 friday-1	 tuesday-2
wauchope crescent	 friday-1	 tuesday-2
waulkmill loan	 wednesday-1	 friday-1
waverley park	None	 thursday-1
waverley park terrace	None	 thursday-1
waverley place	None	 thursday-1
weavers knowe crescent	 wednesday-1	 friday-2
wellflats road	 thursday-1	 tuesday-1
wellhead close	 thursday-1	 tuesday-2
wellington street	None	 thursday-1
west annandale street	 wednesday-1	 thursday-1
west bowling green street	 wednesday-1	 friday-1
west brighton crescent	 friday-2	 wednesday-1
west caiystane road	 tuesday-1	 thursday-1
west castle road	 tuesday-2	 friday-1
west catherine place	 tuesday-2	 wednesday-1
west coates	 tuesday-2	 tuesday-1
west craigs avenue	 thursday-2	 friday-1
west craigs crescent	 thursday-2	 friday-1
west croft	 thursday-1	 wednesday-2
west fairbrae crescent	 thursday-2	 thursday-2
west fairbrae drive	 thursday-2	 thursday-2
west ferryfield	 tuesday-2	 thursday-1
west gorgie place	 tuesday-2	 friday-2
west mains road	 tuesday-2	 tuesday-2
west mayfield	 tuesday-2	 tuesday-1
west mill road	 wednesday-1	 thursday-1
west montgomery place	 wednesday-2	 thursday-1
west newington place	None	 wednesday-2
west pilton avenue	 tuesday-1	 friday-2
west pilton bank	 tuesday-1	 friday-2
west pilton brae	 tuesday-1	 friday-2
west pilton drive	 tuesday-1	 friday-2
west pilton gardens	 tuesday-1	 friday-2
west pilton green	 tuesday-1	 friday-2
west pilton grove	 tuesday-1	 friday-2
west pilton lea	 tuesday-1	 friday-2
west pilton loan	 tuesday-1	 friday-2
west pilton march	 tuesday-1	 friday-2
west pilton park	 tuesday-1	 friday-2
west pilton place	 tuesday-1	 friday-2
west pilton rise	 tuesday-1	 friday-2
west pilton road	None	 friday-2
west pilton street	 tuesday-1	 friday-2
west pilton terrace	 tuesday-1	 friday-2
west pilton view	 tuesday-1	 friday-2
west preston street	None	 thursday-1
west relugas road	 tuesday-2	 tuesday-2
west savile gardens	 tuesday-2	 tuesday-2
west savile road	 tuesday-2	 tuesday-1
west savile terrace	 tuesday-2	 tuesday-2
west scotland street lane	 wednesday-1	 tuesday-2
west stanhope place	 tuesday-2	 wednesday-1
west terrace	 thursday-1	 tuesday-1
west werberside	 tuesday-1	 tuesday-2
west winnelstrae	 tuesday-2	 thursday-1
west woods	 tuesday-1	 tuesday-2
westbank loan	 friday-2	 tuesday-2
westbank place	 friday-2	 tuesday-2
westburn avenue	 wednesday-1	 wednesday-2
westburn grove	 wednesday-1	 wednesday-2
westburn middlefield	 wednesday-1	 wednesday-2
westburn park	 wednesday-1	 wednesday-2
wester broom avenue	 thursday-2	 tuesday-2
wester broom drive	 thursday-2	 tuesday-2
wester broom gardens	 thursday-2	 tuesday-2
wester broom grove	 thursday-2	 tuesday-2
wester broom place	 thursday-2	 tuesday-2
wester broom terrace	 thursday-2	 tuesday-2
wester coates avenue	 tuesday-2	 tuesday-1
wester coates gardens	 tuesday-2	 tuesday-1
wester coates place	 tuesday-1	 wednesday-1
wester coates road	 tuesday-2	 tuesday-1
wester coates terrace	 tuesday-2	 tuesday-1
wester dalmeny steading	 thursday-1	 wednesday-1
wester drylaw avenue	 friday-2	 friday-2
wester drylaw drive	 friday-2	 friday-2
wester drylaw park	 friday-2	 friday-2
wester drylaw place	 friday-2	 friday-2
wester drylaw row	 friday-2	 friday-2
wester hailes road	 tuesday-2	 thursday-2
wester hill	 tuesday-1	 tuesday-1
wester rigg	 wednesday-1	 friday-1
wester row	 thursday-1	 friday-1
wester steil	 tuesday-1	 tuesday-1
western corner	 friday-2	 wednesday-1
western gardens	 friday-1	 thursday-1
western place	 friday-1	 thursday-1
western terrace	 friday-2	 wednesday-1
westfield	 thursday-1	 tuesday-1
westfield road	 tuesday-2	 friday-2
westgarth avenue	 wednesday-2	 tuesday-2
westhall gardens	 tuesday-2	 wednesday-1
wheatlands	 thursday-1	 tuesday-1
whins place	 friday-1	 friday-2
whinstone place	 thursday-1	 wednesday-2
white dales	 tuesday-1	 tuesday-1
whiteadder loan	 thursday-2	 thursday-2
whitehead grove	 thursday-1	 wednesday-1
whitehill street	 wednesday-1a	 thursday-1
whitehouse loan	 tuesday-2	 tuesday-2
whitehouse terrace	 tuesday-2	 tuesday-2
whitelea crescent	 wednesday-1	 thursday-1
whitelea road	 wednesday-1	 thursday-1
whitingford	 wednesday-1	 friday-1
whitson crescent	 wednesday-2	 tuesday-2
whitson grove	 wednesday-2	 tuesday-2
whitson place east	 wednesday-2	 tuesday-2
whitson place west	 wednesday-2	 tuesday-2
whitson road	 wednesday-2	 tuesday-2
whitson terrace	 wednesday-2	 tuesday-2
whitson walk	 wednesday-2	 tuesday-2
whitson way	 wednesday-2	 tuesday-2
wilfrid terrace	 wednesday-2	 thursday-2
wilkieston road	 thursday-1	 wednesday-2
wilkinson drive	None	 wednesday-2
william black place	 thursday-1	 wednesday-1
william jameson place	 friday-1	 friday-2
willow tree place	 wednesday-1	 wednesday-1
willowbrae avenue	 wednesday-2	 wednesday-2
willowbrae gardens	 wednesday-2	 wednesday-2
wilton road	 thursday-2	 tuesday-1
windrush drive	 wednesday-1	 tuesday-1
windsor place	 friday-1	 friday-2
winton drive	 tuesday-1	 tuesday-1
winton gardens	 tuesday-1	 tuesday-1
winton grove	 tuesday-1	 tuesday-1
winton loan	 tuesday-1	 tuesday-1
winton park	 tuesday-1	 tuesday-1
winton terrace	 tuesday-1	 tuesday-1
wintour lane	 wednesday-1	 tuesday-1
wisp green	 friday-1	 tuesday-2
wolrige road	 thursday-2	 thursday-2
wolseley crescent	 wednesday-2	 thursday-2
wolseley gardens	 wednesday-2	 thursday-2
woodbine terrace	 wednesday-1	 thursday-2
woodburn terrace	None	 wednesday-2
woodcroft road	None	 wednesday-2
woodhall avenue	 wednesday-1	 tuesday-1
woodhall drive	 wednesday-1	 tuesday-1
woodhall millbrae	 wednesday-1	 tuesday-1
woodhall terrace	 wednesday-1	 tuesday-1
woodlands grove	 friday-2	 thursday-2
woodside terrace	 friday-2	 tuesday-1
woodstock place	 thursday-2	 friday-1
woodville terrace	 wednesday-1	 thursday-2
wyvern park	 tuesday-2	 wednesday-1
yeaman place	None	 friday-1
yewlands crescent	 thursday-2	 thursday-2
yewlands gardens	 thursday-2	 thursday-2
york place	 wednesday-1	 thursday-1
york road	 tuesday-2	 tuesday-1
yorkston court	 wednesday-1	 friday-1
young drive	 thursday-1	 wednesday-1
zetland place	 tuesday-2	 wednesday-1
balgreen road 167 and 169	None	 friday-2
balgreen road 20-138	None	 wednesday-1
braid road 138-269	None	 thursday-2
braid road 7-126	None	 wednesday-2
broomhouse road 204-214	None	 tuesday-2
broomhouse road 253-365	None	 thursday-2
brunstane road 2-22a	None	 tuesday-1
colinton road 264-292	None	 wednesday-1
corstorphine road 225	None	 friday-2
craigcrook road 51-282	None	 friday-1
craigleith crescent 50-101	None	 tuesday-1
crewe road south 95-141	None	 tuesday-2
drum brae drive 100-224	None	 thursday-2
drum street 87-151	None	 friday-1
duddingston road west 148	None	 tuesday-2
east trinity road 126-145	None	 wednesday-1
east trinity road 5-122	None	 tuesday-1
forth view crescent 95-141	None	 friday-2
hillhouse road 87-131	None	 friday-1
lanark road 487 and 489	None	 tuesday-1
leith walk 302, 318 and 324	None	 friday-1
liberton brae 56-149	None	 thursday-2
mansfield road 200 and 200b	None	 friday-1
milton road east 30-314	None	 tuesday-1
morton street 2-3	None	 friday-2
old dalkeith road 126-164 and 450, 458 and 602	None	 tuesday-2
old dalkeith road 383-395	None	 wednesday-2
old dalkeith road 522-542	None	 friday-1
oxgangs road north 306-346 even	None	 friday-1
peffermill road 178 and 180	None	 tuesday-2
queensferry road 0 eh4 83-195 and 244	None	 wednesday-2
saughton mains avenue 36 and 38	None	 tuesday-2
saughton mains street 1-7	None	 wednesday-2
slateford road 93-124	None	 friday-2
turnhouse road 37 and 142	None	 friday-2
whitehouse road 12-124	None	 wednesday-1
whitehouse road 173-200	None	 tuesday-1
willowbrae road 1-180	None	 wednesday-2
willowbrae road 184-282	None	 thursday-2
woodhall road 11 and 13	None	 tuesday-2
woodhall road 158-180	None	 thursday-1
brunstane road 32-88	None	 wednesday-1
clark road 1-12	None	 wednesday-1
clark road 36-51	None	 tuesday-1
craigcrook road 1-49	None	 wednesday-2
craigleith crescent 1-40	None	 wednesday-2
crewe road south 15-19	None	 wednesday-2
drum brae drive 1-65	None	 tuesday-2
forth view crescent 1-89	None	 wednesday-1
greenbank terrace 1-16	None	 wednesday-2
greenbank terrace 17-24	None	 wednesday-1
hillhouse road 1-68	None	 wednesday-2
kirk brae 2-62	None	 friday-1
kirk brae 64-81	None	 thursday-2
lennox row 9-44	None	 wednesday-1
liberton brae 2-54	None	 wednesday-2
mansfield road 1-88	None	 thursday-1
milton road east 1-26	None	 wednesday-1
morton street 4-65	None	 tuesday-1
old dalkeith road 29-50	None	 thursday-1
queensferry road 0 eh4 1-31	None	 thursday-2
ravelston dykes road 18-97	None	 thursday-1
ravelston dykes road 2-12	None	 friday-1
restalrig road south 27-55	None	 tuesday-1
saughton mains avenue 9-28	None	 wednesday-2
saughton mains place 19-36	None	 tuesday-2
saughton mains place 2-18	None	 wednesday-2
saughton mains street 14-81	None	 tuesday-2
saughton road 12-16	None	 wednesday-2
slateford road 1-35	None	 friday-1
blinkbonny road 0 eh14	 wednesday-1	 friday-1
bridge road 0 eh13	 wednesday-1	 thursday-1
bridge road 0 eh14	 wednesday-1	 friday-1
kirkliston to burnshot 0 c157	None	 thursday-1
calder road 0 eh27	 thursday-1	 tuesday-1
edinburgh road 0 eh28	None	 tuesday-1
edinburgh road 0 eh30	None	 tuesday-1
glasgow road 0 eh12	None	 friday-1
glasgow road 0 eh28	 thursday-1	 wednesday-2
kirkgate 0 eh14	 wednesday-1	 friday-1
kirkgate 0 eh16	 thursday-2	 thursday-2
lennox row 3-7b	None	 tuesday-1
loch road 0 eh30	 thursday-1	 wednesday-1
lochend road 0 eh28	 thursday-1	 wednesday-2
main street 0 eh14	 wednesday-1	 thursday-1
main street 0 eh28	 thursday-1	 wednesday-2
main street 0 eh29	 thursday-1	 thursday-1
main street 0 eh30	 thursday-1	 tuesday-1
manse road 0 eh12	 friday-1	 wednesday-2
manse road 0 eh29	 thursday-1	 thursday-1
pentland avenue 0 eh13	None	 thursday-2
pentland avenue 0 eh14	None	 wednesday-1
pentland view 0 eh10	 tuesday-1	 thursday-2
pentland view 0 eh14	 wednesday-1	 wednesday-1
station road 0 eh12	 friday-1	 friday-2
station road 0 eh28	None	 wednesday-2
station road 0 eh29	None	 thursday-1
station road 0 eh30	None	 wednesday-1
stewart place 0 eh14	 wednesday-1	 wednesday-1
stewart place 0 eh29	 thursday-1	 tuesday-2
stewart terrace 0 eh11	None	 friday-2
stewart terrace 0 eh30	None	 wednesday-1
stirling road 0 eh29	 thursday-1	 thursday-1
the glebe 0 eh29	 thursday-1	 thursday-1
the glebe 0 eh30	 thursday-1	 tuesday-1
the green 0 eh14	 wednesday-1	 friday-1
blinkbonny road 0 eh4	 friday-2	 thursday-2
loch road 0 eh4	 friday-2	 friday-1
lochend road 0 eh6	 wednesday-1	 wednesday-1
main street 0 eh4	 friday-1	 thursday-1
stirling road 0 eh5	 tuesday-2	 wednesday-1
the glebe 0 eh4	 friday-1	 tuesday-1
the green 0 eh4	 friday-1	 thursday-1
alnwickhill road 1-169 odd	None	 thursday-2
alnwickhill road 2-172 even	None	 wednesday-2
bavelaw road 10-22	None	 thursday-1
bavelaw road 58-100	None	 friday-1
bellenden gardens 1-21 and 31-49 odd	None	 wednesday-2
bellenden gardens 23-25 and 55-57 odd and 14-44 even	None	 friday-1
bonaly road 1-47 odd and 4-86 even	None	 tuesday-2
bonaly road 65 and 67	None	 thursday-1
calder road 1-43 odd and 2-22 even	None	 tuesday-2
calder road 181-385 odd and 2-100 even	None	 wednesday-2
calder road 389-503 odd and 298-370 even	None	 thursday-2
clermiston road 103a-133 odd	None	 thursday-2
clermiston road 177-181 odd and 88-94 even	None	 tuesday-1
clermiston road 21-103 odd	None	 wednesday-2
clermiston road 26-72 even	None	 friday-2
colinton road 111-257 odd and 64-262 even	None	 tuesday-1
colinton road 73-99 odd and 16-58 even	None	 friday-1
colinton road 0 eh10 25-63 odd and 6	None	 tuesday-2
colinton road 0 eh13 298-300 even	None	 tuesday-2
corstorphine road 15-43 odd and 2-10 even	None	 tuesday-1
corstorphine road 93-135 odd and 34-98 even	None	 wednesday-1
craigentinny avenue 1-73 odd and 4-96 even	None	 tuesday-1
craigentinny avenue 77-141 odd and 110-144 even	None	 tuesday-2
craigentinny road 1-55 odd and 2-104 even	None	 tuesday-1
craigentinny road 81-125 odd	None	 tuesday-2
craiglockhart road north 15-31 odd and 6-14 even	None	 tuesday-1
craiglockhart road north 33-69 odd and 24-54 even	None	 wednesday-1
craigs road 1-55 odd	None	 friday-1
craigs road 2-44 even	None	 thursday-2
craigs road 64-76 even	None	 friday-2
curriehill road 2-24 even	None	 wednesday-1
curriehill road 63-103 odd	None	 friday-2
drum brae north 1-69 odd and 6-106 even	None	 tuesday-2
drum brae north 121-133 odd and 108	None	 thursday-2
drum street 20-88 even	None	 friday-2
duddingston road west	 friday-1	 thursday-2
ellen's glen road 25-55 odd and 2,4, 26 and 38	None	 friday-2
ellen's glen road 1	None	 thursday-2
firrhill drive 1,3 and 12	None	 tuesday-1
firrhill drive 7-71 odd and 14-46 even	None	 wednesday-1
gilmerton road 213-281 and 451-543 odd	None	 friday-1
gilmerton road 540-544 even	None	 friday-1d
gilmerton road 389-445 odd and 282-406 even	None	 friday-2
grange loan 11-57 odd and 40-80 even	None	 tuesday-1
grange loan 125-157 odd and 186-202 even	None	 tuesday-2
grange loan 61-97 odd and 108-130 even	None	 wednesday-1
lanark road 4-28 even	None	 wednesday-1
lanark road 481-601 odd and 476 632a	None	 friday-2
lanark road 81-453 odd and 214-472	None	 thursday-2
lanark road west 209-577 odd and 196-582 even	None	 friday-1
labark road west boll-o-bere farm	None	 friday-1
lanark road west 3-165 odd and 2-194 even	None	 friday-2
lasswade road 15-79 odd and 54-324 even	None	 thursday-2
lasswade road 217-297 odd	None	 friday-2
leith walk 313 1f2	None	 thursday-1
liberton drive 3-53 odd and 2-52 even	None	 thursday-2
liberton drive 73-101 odd and 54-112 even	None	 wednesday-2
loaning crescent 3,7, 29 and 33 odd and 2-16 even	None	 tuesday-1
loaning crescent 9-27 odd	None	 friday-2
magdalene drive 1-37 odd and 2-104 even	None	 thursday-1
magdalene drive 47-63 odd and 108-174 even	None	 wednesday-1
marionville road 232-258 even	None	 tuesday-1
marionville road 53-153 odd and 38-68 even	None	 thursday-1
maybury road 14 and 15	None	 tuesday-1
maybury road 3 and 5	None	 tuesday-2
maybury road 83 and 85	None	 friday-2
mayfield gardens 1-31 odd	None	 thursday-1
mayfield gardens 2-30 even	None	 tuesday-1
mayfield road 1-167 odd and 8-182 even	None	 tuesday-1
mayfield road 189-205 odd	None	 wednesday-2
minto street 3-27 odd and 4-28 even	None	 thursday-1
minto street 33-47 odd and 32-48 even	None	 tuesday-1
mount vernon road 1-15 odd and 10-34 even	None	 friday-1
mount vernon road 53-69 odd	None	 thursday-2
mountcastle drive north 1-97 odd and 8-120 even	None	 thursday-2
mountcastle drive north 103-105 and 305-331 odd and 128 and 312-328 even	None	 wednesday-2
newliston road 1-11 odd and 4-10 even	None	 thursday-1
oxgangs road north 115 and 117	None	 thursday-1
oxgangs road north 5-223 odd and 14-300 even	None	 tuesday-1
paisley crescent 2-34 even	None	 thursday-2
paisley crescent 5-25 odd and 36-62 even	None	 wednesday-2
peffermill road 1 and 39-49 odd	None	 thursday-1
queensferry road 0 eh29 2-64 even and 21	None	 thursday-1
queensferry road 0 eh29 3-75 odd	None	 tuesday-2
queensferry road 0 eh4 385-409 odd	None	 friday-1
queensferry road 0 eh4 413-563 odd and 536-550 even	None	 tuesday-2
queensferry road 0 eh4 568-634 even	None	 tuesday-1
ravenswood avenue 103-143 odd and 42-58 even	None	 wednesday-2
ravenswood avenue 3-101 and 145-155 odd and 2-90 even	None	 friday-1
redford road 115-133 odd	None	 thursday-1
redford road 201-271 odd	None	 friday-1
redford road 47-109 odd and 4-80 even	None	 tuesday-2
restalrig road south 119-135 odd and 130-166 even	None	 thursday-1
restalrig road south 137-151 odd and 184-194 even	None	 wednesday-1
saughton road 36-48 even	None	 tuesday-2
saughton road 45-69 odd	None	 thursday-2
sighthill avenue 2-28 even	None	 thursday-2
sighthill avenue 3-43 odd	None	 wednesday-2
sighthill view 25-51 odd and 4-66 even	None	 thursday-2
sighthill view 69-81 odd and 72-88 even	None	 thursday-1
silverknowes road 1-63 odd	None	 thursday-1
silverknowes road 26-116 even	None	 thursday-2
slateford road 199-203 odd	None	 wednesday-1
south gyle road 1-43 odd and 2-22 even	None	 tuesday-2
south gyle road 235-327 odd and 40-368 even	None	 friday-1
spylaw bank road 3-15 odd and 6-20 even	None	 thursday-1
spylaw bank road 45-65 odd and 22-76 even	None	 thursday-2
st alban's road 15-47 odd and 2-46 even	None	 tuesday-1
st alban's road 49-115 odd and 52-110 even	None	 tuesday-2
st john's road 251-309 odd and 180-204	None	 wednesday-2
st john's road 45-211 odd and 8-144 even	None	 friday-2
telford road 105-219 odd and 54-244	None	 tuesday-2
telford road 13-63 odd and 18-52 even	None	 wednesday-2
telford road 69-77 odd	None	 friday-2
trinity road 54-68 and 76-134 even and 63-127 odd	None	 tuesday-1
trinity road 70-74 even	None	 wednesday-1
turnhouse road 48-94 even	None	 friday-1
walter scott avenue 3-63 and 103-109 odd	None	 friday-1
walter scott avenue 2-24 and 50-164 even	None	 friday-1
walter scott avenue 67-101 odd and 26-44 even	None	 wednesday-2
west granton road 17-39 odd	None	 friday-2
west granton road 43, 213-257 odd	None	 wednesday-1
abercorn cottages	 wednesday-1	None
affleck way	 wednesday-1	None
albany lane	 wednesday-1	None
albany street lane	 wednesday-1	None
aldermoor avenue	 tuesday-1	None
allermuir road	 wednesday-2	None
alnwickhill road	 thursday-2	None
alva street	 tuesday-1	None
amos crescent	 thursday-2	None
amos crossway	 thursday-2	None
amos place	 thursday-2	None
annandale street lane	 wednesday-1	None
argyle street	 wednesday-1	None
arthur street	 wednesday-1	None
arthur street lane	 wednesday-1	None
ashcroft lane	 wednesday-2	None
ashlar road	 tuesday-1	None
aspen road	 friday-1	None
atholl crescent	 tuesday-1	None
atholl crescent lane	 tuesday-1	None
baberton mains	 wednesday-1	None
baberton road	 wednesday-1	None
back station road	 friday-1	None
baileyfield crescent	 friday-2	None
baker mews	 thursday-1	None
baker wynd	 thursday-1	None
balgreen road	 wednesday-1	None
bankhead drive	 thursday-1	None
bavelaw road	 wednesday-1	None
beale drive	 wednesday-1	None
beale green	 wednesday-1	None
belford mews	 tuesday-1	None
belford road	 friday-2	None
bell's mills	 tuesday-1	None
bellenden gardens	 friday-1	None
belvedere park	 wednesday-1	None
bernard street	 wednesday-1	None
berry drive	 thursday-2	None
birch court	 thursday-2	None
birchwood view	 friday-1	None
boat green	 wednesday-1	None
boathouse bridge road	 thursday-1	None
bonaly road	 wednesday-1a	None
bowling lane	 wednesday-1	None
bowmont place	 friday-1	None
brackenridge view	 thursday-1	None
bradshaw drive	 thursday-2	None
bradshaw lane	 thursday-2	None
braid hills drive	 tuesday-1	None
braid road	 wednesday-2	None
brewery close	 thursday-1	None
bridge street lane	 friday-1	None
briggers walk	 thursday-1	None
briggers way	 thursday-1	None
brocken brigg end	 wednesday-1	None
broomhouse cottages east	 thursday-2	None
broomhouse road	 friday-1	None
broomhouse wynd	 thursday-2	None
broomview path	 thursday-2	None
brosie wynd	 wednesday-1	None
broughton street	 wednesday-1	None
brunstane road	 friday-2	None
builyeon road	 thursday-1	None
burdiehouse crescent	 thursday-1	None
burdock road	 thursday-1	None
burne cruick	 thursday-2	None
byrne crescent	 wednesday-1	None
cables wynd	 wednesday-1	None
caerketton cottages	 tuesday-1	None
cairntows close	 friday-1	None
cakemuir grove	 friday-1	None
calder park	 wednesday-2	None
calder place	 wednesday-2	None
calton road	 wednesday-1	None
cambridge street	 tuesday-1	None
cammo tower grove	 thursday-2	None
cammo tower mews	 thursday-2	None
cammo tower view	 thursday-2	None
campbell park crescent	 wednesday-2	None
campbell park drive	 wednesday-2	None
campion road	 friday-1	None
candlemaker row	 tuesday-1	None
capelaw road	 wednesday-2	None
carlton terrace mews	 wednesday-1	None
carrington road	 tuesday-1	None
carswell crescent	 thursday-1	None
carswell loan	 thursday-1	None
carter mews	 wednesday-1	None
casselbank street	 wednesday-1	None
castle street	 wednesday-1	None
castlebrae avenue	 friday-1	None
castlepark glade	 friday-1	None
castleview drive	 friday-1	None
catelbock gardens	 thursday-1	None
chalmers buildings	 tuesday-2	None
chancelot crescent	 tuesday-2	None
chapel lane	 wednesday-1	None
circus gardens	 wednesday-1	None
clark road	 tuesday-2	None
clarkson road	 wednesday-1	None
clarkson terrace	 wednesday-1	None
claylands road	 thursday-1	None
clermiston road	 friday-1	None
coates crescent	 tuesday-1	None
coates place	 tuesday-1	None
coburg street	 wednesday-1	None
colinton road	 wednesday-2	None
coltbridge millside	 friday-1	None
combe cruik	 wednesday-1	None
constitution place	 wednesday-1	None
constitution street	 wednesday-1	None
cornwallis place	 wednesday-1	None
corslet place	 wednesday-1	None
corstorphine road	 friday-2	None
cove crescent	 wednesday-1	None
craigcrook road	 friday-2	None
craigend park	 friday-1	None
craigentinny avenue	 wednesday-2	None
craigentinny road	 wednesday-2	None
craigleith avenue south	 friday-2	None
craigleith crescent	 friday-2	None
craiglockhart road north	 tuesday-2	None
cramond brig toll	 friday-1	None
crewe road south	 friday-2	None
crookston crescent	 wednesday-1	None
cumberland street north east lane	 wednesday-1	None
cumberland street north west lane	 wednesday-1	None
cumberland street south west lane	 wednesday-1	None
cunningham square	 friday-2	None
curriehill road	 wednesday-1	None
custom house place	 tuesday-2	None
dalkeith road mews	 wednesday-1	None
davies row	 friday-1	None
daybell loan	 thursday-1	None
dean bridge	 wednesday-1	None
dean terrace	 tuesday-1	None
deanery close	 wednesday-2	None
deanhaugh street	 wednesday-1	None
dewar place lane	 tuesday-1	None
dorset place	 tuesday-2	None
douglas gardens mews	 tuesday-1	None
dreghorn cottages	 wednesday-1	None
dreghorn grove	 wednesday-2	None
drum brae drive	 friday-1	None
drum street	 thursday-1	None
drumsheugh place	 tuesday-1	None
dublin meuse	 wednesday-1	None
dudley avenue south	 wednesday-1	None
duke's walk	 wednesday-2	None
dumbryden drive	 wednesday-2	None
duncombe road	 wednesday-2	None
dundas estate	 thursday-1	None
dunkirk road	 friday-1	None
dunnikier lane	 thursday-2	None
duntreath crescent	 friday-1	None
earl grey street	 tuesday-1	None
earl haig gardens	 tuesday-1	None
east adam street	 friday-1	None
east briggers brae	 thursday-1	None
east broughton place	 wednesday-1	None
east hermiston	 thursday-1	None
east rigg farm	 wednesday-1	None
east trinity road	 tuesday-2	None
east werberside	 tuesday-1	None
east werberside place	 tuesday-1	None
easter dalmeny cottages	 thursday-1	None
eastfield road	 thursday-1	None
edinburgh road	 thursday-1	None
egan terrace	 friday-1	None
egypt mews	 tuesday-1	None
elbe street	 wednesday-1	None
electra place	 friday-2	None
eliza wigham place	 wednesday-1	None
ellen's glen road	 thursday-2	None
esdaile park	 tuesday-1	None
eyre terrace	 wednesday-1	None
fairley wynd	 thursday-2	None
ferrymuir gait	 thursday-1	None
figgate lane	 friday-2	None
figgate street	 friday-1	None
fingzies place	 wednesday-1	None
firrhill drive	 tuesday-1	None
firrhill neuk	 tuesday-1	None
fishmarket square	 wednesday-1	None
fordell road	 wednesday-1	None
fordell walk	 wednesday-1	None
forres street	 wednesday-1	None
forth view crescent	 wednesday-1	None
foxhall	 thursday-1	None
foxhall gait	 thursday-1	None
foxhall view	 thursday-1	None
furcheons park	 friday-2	None
garden terrace	 friday-1	None
gaskell street	 wednesday-2	None
gayfield close	 wednesday-1	None
gayfield place	 wednesday-1	None
gayfield place lane	 wednesday-1	None
gayfield street	 wednesday-1	None
george square	 friday-1	None
giles street	 wednesday-1	None
gillerhill	 thursday-1	None
glasgow road	 thursday-1	None
glenarm place	 wednesday-1	None
glennie road	 wednesday-1a	None
glenogle road	 tuesday-1	None
gloucester lane	 wednesday-1	None
gloucester place	 wednesday-1	None
goldenrod street	 friday-1	None
gordon street	 wednesday-1	None
gorgie park close	 tuesday-2	None
gowanhill farm road	 wednesday-1	None
grandfield	 tuesday-2	None
grandville	 tuesday-2	None
grange loan	 tuesday-2	None
grantully place	 wednesday-1	None
great junction street	 wednesday-1	None
greenbank terrace	 tuesday-1	None
greenhill court	 tuesday-1	None
griffin road	 tuesday-1	None
grosvenor street	 tuesday-1	None
grove street	 tuesday-1	None
grubb gardens	 thursday-1	None
grundieswell road	 thursday-1	None
guardianswood	 friday-2	None
haddington place	 wednesday-1	None
haggs farm road	 thursday-1	None
haig lane	 wednesday-1	None
hailesland road	 wednesday-2	None
hamilton wynd	 wednesday-1	None
hamilton's close	 thursday-1	None
harbour lane	 thursday-1	None
harewood drive	 friday-1	None
harper place	 wednesday-1	None
harper walk	 wednesday-1	None
harperrig way	 tuesday-1	None
harrismith place	 wednesday-2	None
hart street	 wednesday-1	None
harvesters way	 wednesday-2	None
haugh park	 wednesday-2	None
haugh street	 wednesday-1	None
haughhead farm	 wednesday-1	None
haven lane	 wednesday-1	None
hawes brae	 thursday-1	None
hawthorn place	 thursday-1	None
hawthornbank lane	 tuesday-1	None
haymarket terrace	 tuesday-1	None
heath road	 tuesday-1	None
heath walk	 tuesday-1	None
hermitage park lea	 wednesday-1	None
hibbert street	 thursday-1	None
high riggs	 tuesday-2	None
hill place	 friday-1	None
hill square	 friday-1	None
hillcoat place	 friday-2	None
hillhouse road	 friday-2	None
hillside road	 friday-1	None
hillside terrace	 friday-1	None
hillwood place	 thursday-1	None
hope park terrace	 wednesday-1	None
hopetoun street	 wednesday-1	None
howard street	 tuesday-1	None
huntingdon place	 wednesday-1	None
industrial road	 wednesday-1	None
inglewood place	 thursday-2	None
inglis green gait	 wednesday-2	None
inglis green rigg	 tuesday-2	None
ingliston gardens	 thursday-1	None
ingliston interchange	 thursday-1	None
ingliston road	 thursday-1	None
innes road	 wednesday-1	None
inverleith terrace lane	 tuesday-1	None
jamaica street north lane	 wednesday-1	None
jane smeal crescent	 wednesday-1	None
jane smeal lane	 wednesday-1	None
jane street	 wednesday-1	None
jeffrey street	 thursday-1	None
john street lane east	 friday-2	None
john street lane west	 friday-1	None
joppa road 76	 friday-1	None
junction place	 wednesday-1	None
kelly place	 friday-1	None
kestrel avenue	 thursday-2	None
kestrel gardens	 thursday-2	None
kimmerghame drive	 tuesday-1	None
king's haugh	 friday-1	None
king's stables road	 tuesday-1	None
kingsknowe park	 wednesday-2	None
kirk brae	 thursday-2	None
kirk cramond	 friday-1	None
lairdship drive	 thursday-2	None
lamb's court	 wednesday-1	None
lanark road west	 wednesday-1	None
lapicide place	 wednesday-1	None
larbourfield	 wednesday-2	None
larchgrove	 wednesday-1	None
latta place	 wednesday-1	None
lauriston street	 tuesday-2	None
lauriston terrace	 friday-1	None
lawnmarket	 tuesday-1	None
leamington lane	 tuesday-2	None
leamington place	 tuesday-1	None
learmonth gardens mews	 tuesday-1	None
leith walk	 wednesday-1	None
lennox row	 tuesday-2	None
lennox street lane	 tuesday-1	None
leven street	 tuesday-1	None
liberton brae	 thursday-2	None
liberton dams	 thursday-2	None
liberton drive	 thursday-1	None
lochiel avenue	 thursday-1	None
lochiel gardens	 thursday-1	None
lochrin buildings	 tuesday-1	None
long craig road	 thursday-1	None
lothian road	 tuesday-1	None
lovers' lane	 thursday-1	None
lowood	 friday-1	None
lufra bank	 tuesday-2	None
lumsden loan	 wednesday-1	None
lymphoy	 wednesday-1	None
lynedoch place lane	 tuesday-1	None
mackenzie place	 wednesday-1	None
macmillan crescent	 tuesday-1	None
macmillan terrace	 tuesday-1	None
magdalene drive	 friday-2	None
malleny	 wednesday-1	None
malta terrace	 tuesday-1	None
mansfield road	 wednesday-1	None
marchhall place	 friday-1	None
mardale crescent	 tuesday-1	None
marionville medway	 wednesday-2	None
marionville road	 wednesday-2	None
mauseley park	 thursday-2	None
maybury road	 thursday-2	None
mcdonald street	 wednesday-1	None
meadow lane	 wednesday-1	None
meadowfield court	 wednesday-1	None
melgund terrace	 wednesday-1	None
melville crescent	 tuesday-1	None
melville street	 monday	None
methvin walk	 friday-1	None
michaelmas grove	 thursday-2	None
middleton avenue	 wednesday-1a	None
millar place	 tuesday-1	None
millerfield place	 tuesday-2	None
milligan street	 friday-1	None
milton grove	 friday-2	None
milton road east	 friday-2	None
moodie walk	 wednesday-1	None
moray park terrace	 wednesday-2	None
morningside court	 tuesday-1	None
morrison crescent	 tuesday-1	None
mortonhall gate	 thursday-1	None
morvenside close	 wednesday-1	None
mount alvernia	 thursday-2	None
mount vernon road	 thursday-2	None
mountcastle drive north	 friday-2	None
muirhouse avenue north	 tuesday-1	None
muirhouse court	 tuesday-1	None
muirhouse crescent	 tuesday-1	None
muirhouse way	 tuesday-1	None
murchie crescent	 friday-1	None
murrayburn green	 wednesday-2	None
myreside court	 tuesday-1	None
nether lennie	 thursday-2	None
nether liberton court	 thursday-2	None
nether liberton lane	 thursday-2	None
new broompark	 tuesday-2	None
new broughton	 wednesday-1	None
new lane	 wednesday-1	None
new mart road	 tuesday-2	None
new orchardfield	 wednesday-1	None
newhaven place	 wednesday-1	None
newliston road	 thursday-1	None
nicolson street	 friday-1	None
niddrie mains terrace	 friday-1	None
niddrie mill grove	 friday-1	None
niddry street	 thursday-1	None
nisbett drive	 wednesday-1	None
north bughtlin place	 thursday-1	None
north cairntow	 friday-1	None
north castle street	 wednesday-1	None
north leith sands	 wednesday-1	None
north werber park	 tuesday-1	None
north werber place	 tuesday-1	None
northumberland place	 wednesday-1	None
northumberland place lane	 wednesday-1	None
northumberland street north east lane	 wednesday-1	None
northumberland street north west lane	 wednesday-1	None
northumberland street south east lane	 wednesday-1	None
northumberland street south west lane	 wednesday-1	None
norton mains	 thursday-1	None
norton park	 wednesday-1	None
o'donnel road	 wednesday-1	None
o'donnel street	 wednesday-1	None
oliphant lane	 tuesday-1	None
orchard toll	 friday-2	None
orwell place	 tuesday-2	None
orwell terrace	 tuesday-2	None
ostler loan	 wednesday-1a	None
oswald court	 tuesday-2	None
oxgangs drive	 tuesday-1	None
oxgangs path	 tuesday-1	None
oxgangs road north	 tuesday-1	None
packer place	 friday-1	None
packer road	 friday-1	None
paisley crescent	 wednesday-2	None
parliament loan	 thursday-1	None
parliament way	 thursday-1	None
peffer place	 friday-1	None
peffermill road	 friday-1	None
pentland avenue	 wednesday-1	None
piershill place	 wednesday-1	None
pilrig house close	 wednesday-1	None
pilrig place	 wednesday-1	None
pinetum lane	 thursday-2	None
pinkhill park 8-	 friday-2	None
pipe street	 friday-2	None
pittville street lane	 friday-1	None
ponton street	 tuesday-1	None
powderhall rigg	 wednesday-1	None
primrose drive	 friday-1	None
princes street	 tuesday-1	None
pringle street	 friday-1	None
pringle terrace	 friday-1	None
provost haugh	 wednesday-1	None
quarry howe	 wednesday-1	None
queen charlotte lane	 wednesday-1	None
queen street	 monday	None
queen's walk	 friday-1	None
queensferry street lane	 tuesday-1	None
quilts wynd	 wednesday-1	None
rackstraw place	 friday-1	None
rae's court	 thursday-2	None
raeburn street	 tuesday-1	None
raith drive	 friday-1	None
raith gait	 friday-1	None
raith gardens	 friday-1	None
raith gate	 friday-1	None
randolph lane	 tuesday-2	None
randolph place	 tuesday-1	None
ransfield road	 thursday-1	None
ratcliffe terrace	 tuesday-2	None
rathbone place	 friday-1	None
rattray crescent	 tuesday-1	None
ravelston dykes road	 friday-1	None
ravenswood avenue	 friday-1	None
redsman drive	 friday-2	None
redsman place	 friday-2	None
redsman street	 friday-2	None
redwing wynd	 thursday-2	None
regent road	 wednesday-1	None
regent street lane	 friday-1	None
regent terrace mews	 wednesday-1	None
reid's court	 thursday-1	None
riverside road	 friday-1	None
robb's loan grove	 tuesday-2	None
robin place	 friday-1	None
rose park	 tuesday-2	None
roseburn gardens	 tuesday-1	None
roseburn maltings	 tuesday-2	None
rosevale place	 wednesday-1	None
rothesay mews	 tuesday-1	None
rothesay place	 tuesday-1	None
royal terrace mews	 wednesday-1	None
russell road	 tuesday-2	None
salisbury place	 tuesday-2	None
sandilands road	 friday-1	None
sandilands view	 friday-1	None
saughton mains avenue	 thursday-2	None
saughton mains park	 thursday-2	None
saughton mains place	 thursday-2	None
sciennes	 tuesday-2	None
seafield place	 wednesday-1	None
seafield road east	 wednesday-1	None
seafield street	 wednesday-1	None
sharp street	 tuesday-1	None
shaw's square	 wednesday-1	None
sheriff bank	 wednesday-1	None
shore	 wednesday-1	None
shore place	 wednesday-1	None
sighthill avenue	 wednesday-2	None
sighthill view	 wednesday-2	None
simon square	 friday-1	None
sir harry lauder road	 friday-2	None
smiddy wynd	 thursday-2	None
south carron crescent	 wednesday-1	None
south carron wynd	 wednesday-1	None
south clerk street	 wednesday-1	None
south east circus place	 wednesday-1	None
south gray's close	 thursday-1	None
south groathill avenue	 friday-2	None
south gyle road	 thursday-2	None
south maybury	 thursday-2	None
south platt hill lane	 thursday-1	None
spylaw bank road	 wednesday-1	None
st aidens place	 friday-1	None
st aidens road	 friday-1	None
st alban's road	 tuesday-2	None
st andrew place	 wednesday-1	None
st colme street	 wednesday-1	None
st cuthbert's court	 wednesday-2	None
st john street	 thursday-1	None
st john's road	 friday-1	None
st leonard's street	 friday-1	None
st peter's buildings	 tuesday-1	None
st vincent street	 wednesday-1	None
stable lane	 tuesday-2	None
stafford street	 tuesday-1	None
stevedore place	 wednesday-1	None
stewart terrace	 thursday-1	None
stuart square	 thursday-1	None
summerbank	 wednesday-1	None
sunbury mews	 tuesday-1	None
sunbury street	 tuesday-1	None
sunnyside	 wednesday-1	None
swanfield	 wednesday-1	None
syme crescent	 tuesday-1	None
telford road	 friday-2	None
temple drive	 thursday-1	None
temple place	 thursday-1	None
terrars croft	 friday-1	None
the lade	 wednesday-1	None
the limes	 tuesday-2	None
the vennel	 thursday-1	None
timber bush	 wednesday-1	None
torphichen street	 tuesday-1	None
torphin bank	 wednesday-2	None
torphin road	 wednesday-2	None
tower street	 wednesday-1	None
trafalgar lane	 tuesday-1	None
trinity road	 tuesday-2	None
trinity way	 tuesday-2	None
turnhouse farm road	 thursday-2	None
turnhouse road	 thursday-2	None
tytler gardens	 wednesday-1	None
umbrella pine terrace,	 thursday-2	None
underwoods grove	 wednesday-1	None
union street	 wednesday-1	None
upper deanpark farm	 wednesday-1	None
upper hermitage	 wednesday-1	None
veitch's square	 wednesday-1	None
vernon cottages	 friday-1	None
walker street	 tuesday-1	None
walter scott avenue	 friday-1	None
wantonwalls view	 wednesday-1a	None
wardie square	 tuesday-1	None
wardieburn place north	 tuesday-2	None
wardieburn place south	 tuesday-2	None
wardieburn street west	 tuesday-2	None
wardiefield	 tuesday-2	None
warriston farm road	 wednesday-1	None
washington lane	 tuesday-1	None
waterfront avenue	 tuesday-1	None
waterson avenue	 friday-1	None
watt gardens	 friday-1	None
wauchope terrace	 friday-1	None
weir street	 thursday-2	None
well court	 tuesday-1	None
well spring close	 tuesday-1	None
wellingtonia crescent	 thursday-2	None
wemyss place	 wednesday-1	None
wemyss place mews	 wednesday-1	None
werberside mews	 tuesday-1	None
west bryson road	 tuesday-2	None
west carnethy avenue	 wednesday-2	None
west cherrybank	 wednesday-1	None
west craigie farm road	 thursday-1	None
west end place	 tuesday-2	None
west gait	 wednesday-1	None
west harbour road	 tuesday-2	None
west maitland street	 tuesday-1	None
west mill bank	 wednesday-1	None
west pilton crescent	 tuesday-1	None
west pilton crossway	 tuesday-1	None
west powburn	 tuesday-2	None
west shore road	 tuesday-1	None
west silvermills lane	 wednesday-1	None
west telferton	 wednesday-2	None
west tollcross	 tuesday-2	None
westbank street	 friday-2	None
wester hailes park	 wednesday-2	None
westland cottages	 thursday-1	None
westmost close	 wednesday-1	None
whitehouse road	 friday-1	None
whitelaw	 wednesday-1	None
whitelaw crossing cottage	 wednesday-1	None
william street	 tuesday-1	None
william street north east lane	 tuesday-1	None
william street north west lane	 tuesday-1	None
william street south east lane	 tuesday-1	None
william street south west lane	 tuesday-1	None
wilson's park	 friday-1	None
windmill place	 friday-1	None
winterburn place	 wednesday-2	None
woodfield avenue	 wednesday-2	None
woodfield park	 wednesday-2	None
woodhall bank	 wednesday-2	None
woodhall grove	 wednesday-2	None
woolmet place	 friday-1	None
yarrow place	 thursday-2	None
young street	 wednesday-1	None
young street north lane	 wednesday-1	None
duddingston road west 29 - 41 and 24 -92	 friday-2	None
ferry road 3 - 243 and 28 - 530	 tuesday-2	None
gilmour road 1 - 10	 tuesday-2	None
gilmour road 11 - 53	 thursday-2	None
gorgie road 190 and 206	 tuesday-1	None
gracemount drive 2 and 20	 thursday-1	None
granby road 1 - 5a	 tuesday-2	None
granby road 5b - 52	 thursday-2	None
howden hall road 1 - 10	 thursday-2	None
howden hall road 12 - 80	 thursday-1	None
joppa road 1 - 109	 friday-2	None
loaning crescent 1 - 7 and 29 - 35	 wednesday-2	None
loaning crescent 9 - 27	 wednesday-1	None
minto street 1 - 30	 wednesday-1	None
minto street 31 - 51	 tuesday-2	None
newington road 76 and 86	 tuesday-2	None
old church lane 3 and 5	 friday-2	None
pilton avenue 213 - 363 and 100 - 206	 tuesday-1	None
pilton avenue 5 - 211 and 2 - 98	 tuesday-2	None
queensferry road 5 -195 and 84 - 236 eh4	 friday-2	None
woodhall road 154  184	 wednesday-1a	None
glenbrook road 70a to b7031	 wednesday-1	None
kirkliston to burnshot 157c	 thursday-1	None
bonnington road 0 eh27	 thursday-1	None
bridge street 0 eh15	 friday-2	None
bridge street 0 eh28	 thursday-1	None
high street 0 eh29	 thursday-1	None
high street 0 eh30	 thursday-1	None
hope street 0 eh30	 thursday-1	None
queensferry road 0 eh29	 thursday-1	None
riverside 0 eh28	 thursday-1	None
station road 0 eh29 and eh30	 thursday-1	None
bonnington road 0 eh6	 wednesday-1	None
high street 0 eh1	 thursday-1	None
hope street 0 eh2	 tuesday-2	None
riverside 0 eh4	 friday-1	None
abinger gardens 1a	 friday-2	None
belford road 32	 tuesday-2	None
belford road 76	 friday-2	None
boswall parkway 1 - 67 odd and 2 - 120 even	 tuesday-2	None
boswall parkway 73 - 121 odd and 122 - 216 even	 tuesday-1	None
braid avenue 43 - 75 odd and 2 - 22 even	 tuesday-1	None
braid avenue 5 - 39 odd	 tuesday-2	None
broomhall drive 1 - 111 odd	 friday-1	None
broomhall drive 2 - 110 even	 thursday-2	None
broomhouse road 204 - 220 even	 friday-1	None
broomhouse road 241 - 365 odd and 354 - 358 even	 thursday-2	None
calder road 1 - 509 odd	 wednesday-2	None
calder road 2 - 100 even	 thursday-2	None
calder road 298 - 370 even	 thursday-2	None
captain's drive 11 - 79 odd and 16 - 44 even	 thursday-1	None
captain's drive 81 - 117 odd and 46 - 82 even	 thursday-2	None
cluny gardens even	 tuesday-1	None
cluny gardens odd	 tuesday-2	None
colinton road 105 - 301 odd and 62 - 300 even	 wednesday-2	None
colinton road 7 - 99 odd and 2 - 36 even	 tuesday-2	None
corbiehill road 1 - 23 odd and 2 - 28 even	 friday-2	None
corbiehill road 25 - 77 odd and 30 - 64	 friday-1	None
corstorphine road 223, 225, 233 and 134	 friday-1	None
craighall road 7, 87 and 99	 wednesday-1	None
craigleith road even	 friday-2	None
craigleith road odd	 tuesday-2	None
craiglockhart park 6 - 24 even and 25 - 53	 tuesday-2	None
craigmillar park 2, 4, 6, 8	 tuesday-2	None
craigs road	 thursday-2	None
craigs road 120, 93 and 85	 thursday-1	None
crewe road south 15 - 23 odd	 tuesday-2	None
crewe road south 95 - 141 odd	 friday-2	None
dalkeith road even	 wednesday-1	None
dalkeith road odd	 friday-1	None
dick place 38	 tuesday-1a	None
drum brae north even	 thursday-2	None
drum brae north odd	 friday-1	None
drum brae south even	 friday-1	None
drum brae south odd	 thursday-2	None
duddingston park south 55 - 201 odd and 46 - 216 even	 friday-1	None
duddingston park south 9 - 33 odd and 2 - 44 even	 friday-2	None
duddingston road west 131, 124 - 148 even	 friday-1	None
easter road 25, 77, 12 and 170	 wednesday-2	None
easter road 268	 wednesday-1	None
ferry road 700 - 740 even	 tuesday-1	None
ferry road avenue 1 - 33 odd and 2 - 50 even	 tuesday-1	None
ferry road avenue 37 - 41 odd	 friday-1	None
gillespie road 19	 wednesday-2	None
gilmerton road 221 - 229 odd	 friday-1	None
gilmerton road 401-543 odd and 406 - 500 even	 thursday-1	None
gilmerton road 8-20 even and 282 - 366 even & 207 - 219 odd	 thursday-2	None
glasgow road 25 - 103 odd and 2 - 164 even eh12	 thursday-2	None
glenlockhart road 2	 tuesday-1	None
gorgie road 259 - 545 odd and 394 - 496 even	 tuesday-2	None
gorgie road 570	 friday-2	None
kingsknowe road north 203	 tuesday-2	None
lanark road 2 - 464 even and 27 - 121 odd	 tuesday-2	None
lanark road 293 - 601 odd and 476 - 632 even	 wednesday-1	None
lasswade road 1 - 79 odd and 4 - 136 even	 thursday-2	None
lasswade road 217 - 297 odd and 248 - 328 even	 thursday-1	None
mayfield gardens 1 - 39 odd	 wednesday-1	None
mayfield gardens 2 - 32 even	 tuesday-2	None
mayfield road 103 - 205 odd	 thursday-2	None
mayfield road 2 - 182 even and 1 - 101 odd	 tuesday-2	None
moira terrace 48 and 125	 wednesday-1	None
morton street 3 - 15 odd and 2 - 8 even	 friday-1	None
morton street 31 - 63 odd and 12 - 40	 friday-2	None
northfield broadway 84	 wednesday-2	None
old dalkeith road 13 -89 odd and 42 -140 even	 friday-1	None
old dalkeith road 139 - 217 odd and 164 - 700	 thursday-1	None
pilton drive 1 - 91 odd	 tuesday-2	None
pilton drive 2 - 100 even	 tuesday-1	None
pilton drive north even	 tuesday-1	None
pilton drive north odd	 tuesday-2	None
pinkhill park 1	 friday-1	None
queensferry road 385 - 555 odd and 568 - 634	 friday-1	None
queensferry road 534 - 554 even and 559 - 599 odd	 thursday-2	None
queensferry road 1	 wednesday-1	None
redford road 111 - 171 odd	 wednesday-1	None
redford road 47 - 87 odd and 4 - 80 even	 wednesday-2	None
restalrig road south 137 -161 odd and 178 - 198 even	 wednesday-1	None
restalrig road south 7 - 135 odd and 50 - 174 even	 wednesday-2	None
saughton mains street	 thursday-2	None
saughton mains street 98 flat 1	 thursday-1	None
saughton road 41 - 67 odd	 thursday-2	None
saughton road 8 - 40 even	 thursday-2	None
sighthill court 2 - 22 even	 thursday-2	None
sighthill court 1a	 wednesday-2	None
silverknowes road 7 - 63 odd and 26 -120 even	 tuesday-1	None
silverknowes road 1, 3, 5	 friday-1	None
slateford road 104 -122 even	 tuesday-2	None
slateford road 201 -207 odd	 tuesday-2	None
slateford road 62 - 100 even	 tuesday-1	None
sleigh drive even	 wednesday-2	None
sleigh drive odd	 wednesday-1	None
south oswald road 71 - 75	 tuesday-1	None
stenhouse road 6 - 74 even	 wednesday-2	None
stenhouse road 7 - 55 odd	 wednesday-2	None
strathalmond green 20	 friday-1	None
suffolk road even	 thursday-2	None
suffolk road odd	 tuesday-2	None
west granton road 213 - 225 odd and 120 - 146 even	 tuesday-1	None
west granton road 3 - 43 odd and 70	 tuesday-2	None
whitehouse loan 162 -172 even	 tuesday-1	None
willowbrae road 161 - 165 odd and 233	 friday-2	None
willowbrae road	 wednesday-2	None
woodhall road except 154-184	 wednesday-2	None
